#separator:tab
#html:false
#tags column:3
Die Zeit ~ Die Zeiten	Time	
Der Man ~ Die Männer	Man	
Die Hand ~ Die Hände	Hand	
Der Tag ~ Die Tagen	Day	
Der Weg ~ Die Wege	Way	
Das Auge ~ Die Augen	Eye	
Das Ding ~ Die Dinge	Thing	
Der Kopf ~ Die Köpfe	Head	
Das Jahr ~ Die Jahre	Year	
Die Raum ~ Die Räume	Room	
Die Tür ~ Die Türen	Door	
Die Frau ~ Die Frauen	Woman	
Das Gesicht ~ Die Gesichter	Face	
Die Mutter ~ Die Mütter	Mother	
Das Volk ~ Die Völker	People	
Die Nacht ~ Die Nächte	Night	
Das Haus ~ Die Häuser	House	
Der Vater ~ Die Väter	Father	
Das Leben ~ Die Leben	Life	
Der Rücken ~ Die Rücken	Back	
Die Stimme ~ Die Stimmen	Voice	
Das Mädchen ~ Die Mädchen	Girl	
Der Ort ~ Die Orte	Place	
Der Junge ~ Die Jungen	Boy	
Das Auto ~ Die Autos	Car	
Die Seite ~ Die Seiten	Side	
Der Arm ~ Die Arme	Arm	
Das Kind ~ Die Kinder	Child	
Das Wort ~ Die Worte	Word	
Der Moment ~ Die Momente	Moment	
Das Haar ~ Die Haare	Hair	
Der Fuß ~ Die Füße	Foot	
Das Wasser ~ Die Wasser	Water	
Das Licht ~ Die Lichter	Light	
Die Welt ~ Die Welt	World	
Der Name ~ Die Namen	Name	
Der Freund ~ Die Freunde	Friend	
Das Fenster ~ Die Fenster	Window	
Der Körper ~ Die Körper	Body	
Der Tisch ~ Die Tabellen	Table	
Der Morgen ~ Die Morgen	Morning	
Das Bett ~ Die Betten	Bed	
Die Mauer ~ Die Wände	Wall	
Die Straße ~ Die Straßen	Street	
Die Schule ~ Die Schulen	School	
Die Luft ~ Die Lüfte	Air	
Der Boden ~ Die Böden	Floor	
Die Stunde ~ Die Stunden	Hour	
Das Ende ~ Die Enden	End	
Die Familie ~ Die Familien	Family	
Der Kerl ~ Die Kerle	Guy	
Die Art ~ Die Arten	Kind	
Die Minute ~ Die Minuten	Minute	
Die Geschichte ~ Die Geschichten	Story	
Der Gott ~ Die Götter	God	
Die Woche ~ Die Wochen	Week	
Die Arbeit ~ Die Werke	Work	
Die Schulter ~ Die Schultern	Shoulder	
Der Teil ~ Die Teile	Part	
Der Geist ~ Die Gemüter	Mind	
Das Buch ~ Die Bücher	Book	
Der Finger ~ Die Finger	Finger	
Der Mund ~ Die Mündungen	Mouth	
Das Glas ~ Die Brille	Glass	
Der Baum ~ Die Bäume	Tree	
Der Klang ~ Die Geräusche	Sound	
Die Linie ~ Die Linien	Line	
Die Ehefrau ~ Die Ehefrauen	Wife	
Das Herz ~ Die Herzen	Heart	
Das Geld ~ Die Gelder	Money	
Das Telefon ~ Die Telefone	Phone	
Das Aussehen ~ Die Blicke	Look	
Das Bein ~ Die Beine	Leg	
Der Stuhl ~ Die Stühle	Chair	
Das Büro ~ Die Büros	Office	
Der Bruder ~ Die Brüder	Brother	
Die Frage ~ Die Fragen	Question	
Die Stadt ~ Die Städte	City	
Der Monat ~ Die Monate	Month	
Das Baby ~ Die Babys	Baby	
Das Zuhause ~ Die Häuser	Home	
Der Hund ~ Die Hunde	Dog	
Die Idee ~ Die Ideen	Idea	
Die Küche ~ Die Küchen	Kitchen	
Das Los ~ Die Lose	Lot	
Der Sohn ~ Die Söhne	Son	
Der Beruf ~ Die Jobs	Job	
Das Papier ~ Die Papiere	Paper	
Die Schwester ~ Die Schwestern	Sister	
Das Lächeln ~ Die Lächeln	Smile	
Der Punkt ~ Die Punkte	Point	
Der Gedanke ~ Die Gedanken	Thought	
Die Liebe ~ Die Liebe	Love	
Der Tod ~ Die Todesfälle	Death	
Der Boden ~ Die Gründe	Ground	
Die Anderen ~ Die Anderen	Others	
Das Feuer ~ Die Feuer	Fire	
Der Schritt ~ Die Schritte	Step	
Das Blut ~ Die Blut	Blood	
Die Tatsache ~ Die Fakten	Fact	
Der Atem ~ Die Atem	Breath	
Die Lippe ~ Die Lippen	Lip	
Die Sonne ~ Die Sonnen	Sun	
Gebäude ~ Die Gebäude	Building	
Die Anzahl ~ Die Nummern	Number	
Der Ehemann ~ Die Ehemänner	Husband	
Das Elternteil ~ Die Eltern	Parent	
Die Ecke ~ Die Ecken	Corner	
Das Problem ~ Die Probleme	Problem	
Das Ehepaar ~ Die Paare	Couple	
Die Tochter ~ Die Töchter	Daughter	
Der Beutel ~ Die Taschen	Bag	
Die Hölle ~ Die Höllen	Hell	
Die Rast ~ Die Reste	Rest	
Das Geschäft ~ Die Unternehmen	Business	
Der Himmel ~ Der Himmel	Sky	
Die Kiste ~ Die Boxs	Box	
Die Person ~ Die Personen	Person	
Der Grund ~ Die Gründe	Reason	
Das Recht ~ Die Rechte	Right	
Die Haut ~ Die Häute	Skin	
Der Fall ~ Die Fälle	Case	
Das Stück ~ Die Stücke	Piece	
Der Doktor ~ Die Doktoren	Doctor	
Die Ecke ~ Die Kanten	Edge	
Die Mama ~ Die Mütter	Mom	
Das Bild ~ Die Bilder	Picture	
Der Sinn ~ Die Sinne	Sense	
Das Ohr ~ Die Ohren	Ear	
Der Zweite ~ Die Sekunden	Second	
Die Dame ~ Die Damen	Lady	
Der Hals ~ Die Hälse	Neck	
Der Wind ~ Die Winde	Wind	
Der Schreibtisch ~ Die Schreibtische	Desk	
Die Waffe ~ Die Waffen	Gun	
Der Stein ~ Die Steine	Stone	
Der Kaffee ~ Die Kaffee	Coffee	
Das Schiff ~ Die Schiffe	Ship	
Die Erde ~ Die Erden	Earth	
Das Essen ~ Die Lebensmittel	Food	
Das Pferd ~ Die Pferde	Horse	
Das Feld ~ Die Felder	Field	
Der Krieg ~ Die Kriege	War	
Der Nachmittag ~ Die Nachmittage	Afternoon	
Die Sir ~ Die Damen Und Herren	Sir	
Der Raum ~ Die Räume	Space	
Der Abend ~ Die Abende	Evening	
Der Brief ~ Die Briefe	Letter	
Die Bar ~ Die Bars	Bar	
Der Traum ~ Die Träume	Dream	
Die Wohnung ~ Die Wohnungen	Apartment	
Die Brust ~ Die Truhen	Chest	
Das Spiel ~ Die Spiele	Game	
Der Sommer ~ Die Sommer	Summer	
Der Grund ~ Die Angelegenheiten	Matter	
Die Stille ~ Die Stille	Silence	
Die Spitze ~ Die Spitzen	Top	
Der Fels ~ Die Steine	Rock	
Die Macht ~ Die Befugnisse	Power	
Die Kleider ~ Die Clotheses	Clothes	
Das Schild ~ Die Zeichen	Sign	
Die Aufmerksamkeit ~ Die Aufmerksamkeit	Attention	
Die Musik ~ Die Musiken	Music	
Der Staat ~ Die Staaten	State	
Die Tasche ~ Die Taschen	Pocket	
Das Abendessen ~ Die Abendessen	Dinner	
Die Halle ~ Die Hallen	Hall	
Der Schmerz ~ Die Schmerzen	Pain	
Das Alter ~ Das Alter	Age	
Der Fluss ~ Die Flüsse	River	
Die Chance ~ Die Chancen	Chance	
Die Nase ~ Die Nasen	Nose	
Der Schatten ~ Die Schatten	Shadow	
Die Polizei ~ Die Politiken	Police	
Das Gedächtnis ~ Die Erinnerungen	Memory	
Die Farbe ~ Die Farben	Color	
Das Knie ~ Die Knie	Knee	
Das Holz ~ Der Wald	Wood	
Das Hemd ~ Die Hemden	Shirt	
Die Party ~ Die Parteien	Party	
Das Land ~ Die Länder	Country	
Der Lkw ~ Die Lastwagen	Truck	
Der Zahn ~ Die Tooths	Tooth	
Die Rechnung ~ Die Rechnungen	Bill	
Die Szene ~ Szenen	Scene	
Das Land ~ Die Ländereien	Land	
Der Stern ~ Die Sterne	Star	
Der Vogel ~ Die Vögel	Bird	
Das Schlafzimmer ~ Die Schlafzimmer	Bedroom	
Der Onkel ~ Die Onkel	Uncle	
Die Art ~ Die Sorten	Sort	
Die Gruppe ~ Die Gruppen	Group	
Die Wahrheit ~ Die Wahrheiten	Truth	
Die Schwierigkeiten ~ Die Probleme	Trouble	
Die Menge ~ Die Menschenmengen	Crowd	
Der Bahnhof ~ Die Stationen	Station	
Die Reiß ~ Die Tränen	Tear	
Die Klasse ~ Die Klassen	Class	
Das Meer ~ Die Meere	Sea	
Das Tier ~ Die Tiere	Animal	
Das Zentrum ~ Die Zentren	Center	
Das Gefühl ~ Die Gefühle	Feeling	
Das Geschäft ~ Die Läden	Store	
Der Berg ~ Die Berge	Mountain	
Die Nachrichten ~ Die Newses	News	
Der Schuh ~ Die Schuhe	Shoe	
Die Katze ~ Die Katzen	Cat	
Der Bildschirm ~ Die Schirme	Screen	
Die Flasche ~ Die Flaschen	Bottle	
Der Anruf ~ Die Anrufe	Call	
Die Lebenden ~ Die Livings	Living	
Die Wange ~ Die Wangen	Cheek	
Der Schüler ~ Die Studenten	Student	
Der Ball ~ Die Bälle	Ball	
Die Sehenswürdigkeit ~ Die Sehenswürdigkeiten	Sight	
Der Hügel ~ Die Hügel	Hill	
Das Unternehmen ~ Die Betriebe	Company	
Die Kirche ~ Die Kirchen	Church	
Der Regen ~ Die Regenzeit	Rain	
Der Anzug ~ Die Anzüge	Suit	
Der Eine ~ Die Einen	One	
Die Richtung ~ Die Richtungen	Direction	
Der Wille ~ Die Testamente	Will	
Der Hals ~ Die Kehlen	Throat	
Die Mitte ~ Die Middles	Middle	
Die Antwort ~ Die Antworten	Answer	
Das Zeug ~ Die Stoffe	Stuff	
Das Krankenhaus ~ Die Krankenhäuser	Hospital	
Die Kamera ~ Die Kameras	Camera	
Das Kleid ~ Die Kleider	Dress	
Die Karte ~ Die Karten	Card	
Der Hof ~ Die Werften	Yard	
Die Dunkelheit ~ Die Dunkelheiten	Dark	
Die Scheiße ~ Die Scheiße	Shit	
Die Maschine ~ Die Maschinen	Machine	
Die Distanz ~ Die Abstände	Distance	
Das Gebiet ~ Die Bereiche	Area	
Der Erzähler ~ Die Erzähler	Narrator	
Das Eis ~ Die Ices	Ice	
Der Schnee ~ Der Schnee	Snow	
Die Notiz ~ Die Notizen	Note	
Der Spiegel ~ Die Spiegel	Mirror	
Der König ~ Die Könige	King	
Die Angst ~ Die Ängste	Fear	
Der Offizier ~ Die Offiziere	Officer	
Das Loch ~ Die Löcher	Hole	
Der Schuss ~ Die Schüsse	Shot	
Der Wächter ~ Die Wachen	Guard	
Die Unterhaltung ~ Die Gespräche	Conversation	
Das Boot ~ Die Boote	Boat	
Das System ~ Die Systeme	System	
Die Pflege ~ Die Sorgen	Care	
Die Bit ~ Die Bits	Bit	
Der Film ~ Kino	Movie	
Der Knochen ~ Die Knochen	Bone	
Der Kapitän ~ Die Kapitäne	Captain	
Die Tante ~ Die Tanten	Aunt	
Dunkelheit ~ Die Dunkelheiten	Darkness	
Die Kontrolle ~ Die Steuerelemente	Control	
Das Getränk ~ Die Getränke	Drink	
Das Hotel ~ Die Hotels	Hotel	
Der Mantel ~ Die Mäntel	Coat	
Die Treppen ~ Die Treppe	Stair	
Die Bestellung ~ Die Aufträge	Order	
Die Rose ~ Die Rosen	Rose	
Der Fehl ~ Die Fehlschüsse	Miss	
Der Hut ~ Die Hüte	Hat	
Das Gold ~ Die Goldmedaillen	Gold	
Die Zigarette ~ Die Zigaretten	Cigarette	
Die Wolke ~ Die Wolken	Cloud	
Die Aussicht ~ Die Ansichten	View	
Der Fahrer ~ Die Fahrer	Driver	
Die Tasse ~ Die Tassen	Cup	
Die Figur ~ Die Figuren	Figure	
Der Ausdruck ~ Die Ausdrücke	Expression	
Der Pfad ~ Die Wege	Path	
Der Schlüssel ~ Die Schlüssel	Key	
Der Computer ~ Die Computer	Computer	
Die Blume ~ Die Blumen	Flower	
Der Ring ~ Die Ringe	Ring	
Das Bad ~ Die Badezimmer	Bathroom	
Das Metall ~ Die Metalle	Metal	
Der Mond ~ Die Monde	Moon	
Das Lied ~ Die Lieder	Song	
Der Soldat ~ Die Soldaten	Soldier	
Das Radio ~ Die Funkgeräte	Radio	
Die Welle ~ Die Wellen	Wave	
Der Plan ~ Die Pläne	Plan	
Das College ~ Die Fachhochschulen	College	
Der Fisch ~ Die Fische	Fish	
Der Garten ~ Die Gärten	Garden	
Der Zug ~ Die Züge	Train	
Der Polizist ~ Die Polizisten	Cop	
Die Kunst ~ Die Künste	Art	
Das Bier ~ Die Biere	Beer	
Norden ~ Die Norths	North	
Die Insel ~ Die Inseln	Island	
Der Bus ~ Die Busse	Bus	
Der Geruch ~ Die Gerüche	Smell	
Das Geräusch ~ Die Geräusche	Noise	
Die Mama ~ The Mamas	Mama	
Der Park ~ Die Parks	Park	
Der Süden ~ Die Souths	South	
Das Paar ~ Die Paare	Pair	
Der Herr ~ Die Herren	Lord	
Der Teller ~ Die Platten	Plate	
Die Jacke ~ Die Jacken	Jacket	
Die Hilfe ~ Die Hilft	Help	
Der Papa ~ Die Väter	Daddy	
Das Gras ~ Die Gräser	Grass	
Die Dank ~ Die Thankses	Thanks	
Die Hitze ~ Die Heats	Heat	
Der Schlaf ~ Die Schlafplätze	Sleep	
Das Gehirn ~ Die Gehirne	Brain	
Der Service ~ Der Dienstleistungen	Service	
Die Reise ~ Die Ausflüge	Trip	
Der Beat ~ Die Beats	Beat	
Das Messer ~ Die Messer	Knife	
Der Platz ~ Die Flecken	Spot	
Die Nachricht ~ Die Nachrichten	Message	
Die Note ~ Die Noten	Mark	
Der Lehrer ~ Die Lehrer	Teacher	
Der Blick ~ Die Blicke	Gaze	
Das Dorf ~ Die Dörfer	Village	
Der Winter ~ Die Winter	Winter	
Die Front ~ Die Fronten	Front	
Das Gesetz ~ Die Gesetze	Law	
Die Oberfläche ~ Die Oberflächen	Surface	
Die Bank ~ Die Banken	Bank	
Das Team ~ Die Teams	Team	
Das Maximum ~ Die Maxima	Maximum	
Die Position ~ Die Positionen	Position	
Der Bauch ~ Die Mägen	Stomach	
Die Wende ~ Die Windungen	Turn	
Der Westen ~ Die Wests	West	
Das Mittagessen ~ Die Mittagessen	Lunch	
Der Wechsel ~ Die Veränderungen	Change	
Die Kreatur ~ Geschöpfe	Creature	
Die Seele ~ Die Seelen	Soul	
Das Blatt ~ Die Blätter	Leaf	
Die Show ~ Die Shows	Show	
Die Gate ~ Die Tore	Gate	
Die Palme ~ Die Handflächen	Palm	
Der Kunststoff ~ Die Kunststoff	Plastic	
Die Kraft ~ Die Kräfte	Force	
Der Strand ~ Die Strände	Beach	
Der Präsident ~ Die Präsidenten	President	
Die Form ~ Die Formen	Shape	
Der Rauch ~ Die Raucht	Smoke	
Das Rad ~ Die Räder	Wheel	
Das Silber ~ Die Silber	Silver	
Das Dach ~ Die Dächer	Roof	
Das Gewicht ~ Die Gewichte	Weight	
Die Zunge ~ Die Zungen	Tongue	
Der Tee ~ Die Tees	Tea	
Die Strecke ~ Die Spuren	Track	
Der Winkel ~ Die Winkel	Angle	
Die Form ~ Formen	Form	
Der Ton ~ Die Töne	Tone	
Der Kreis ~ Die Kreise	Circle	
Der Frühling ~ Die Federn	Spring	
Die Vorhalle ~ Die Veranden	Porch	
Das Mitglied ~ Die Angehörigen	Member	
Das Schwimmbecken ~ Die Pools	Pool	
Das Bedürfnis ~ Die Bedürfnisse	Need	
Die Hoffnung ~ Die Hoffnungen	Hope	
Der See ~ Die Seen	Lake	
Die Brust ~ Die Brüste	Breast	
Die Überraschung ~ Die Überraschungen	Surprise	
Die Interesse ~ Die Interessen	Interest	
Der Geist ~ Die Geister	Spirit	
Der Block ~ Die Blöcke	Block	
Die Sprache ~ Die Sprachen	Language	
Die Brücke ~ Die Brücken	Bridge	
Staub ~ Die Stäube	Dust	
Die Zelle ~ Die Zellen	Cell	
Wein ~ Die Weine	Wine	
Das Boot ~ Die Stiefel	Boot	
Die Wahl ~ Die Entscheidungen	Choice	
Die Reihe ~ Die Reihen	Row	
Das Gespräch ~ Die Gespräche	Talk	
Das Flugzeug ~ Die Flugzeuge	Plane	
Die Uhr ~ Die Uhren	Watch	
Die Information ~ Die Informationen	Information	
Die Großmutter ~ Die Großmütter	Grandmother	
Der Flügel ~ Die Flügel	Wing	
Die Bob ~ Die Bobs	Bob	
Der Club ~ Die Vereine	Club	
Der Meister ~ Die Meister	Master	
Die Gnade ~ Die Gnaden	Grace	
Der Wald ~ Die Wälder	Forest	
Die Größe ~ Die Größen	Size	
Der Satz ~ Die Sätze	Set	
Die Ehe ~ Die Ehen	Marriage	
Die Stirn ~ Die Stirn	Forehead	
Sturm ~ Die Stürme	Storm	
Die Türöffnung ~ Die Türen	Doorway	
Die Situation ~ Die Situationen	Situation	
Der Zähler ~ Die Zähler	Counter	
Der Nachbar ~ Die Nachbarn	Neighbor	
Das Foto ~ Die Fotos	Photo	
Die Bühne ~ Die Stufen	Stage	
Das Treffen ~ Die Sitzungen	Meeting	
Die Krankenschwester ~ Die Krankenschwestern	Nurse	
Die Sicherheit ~ Die Wertpapiere	Security	
Die Waffe ~ Waffen	Weapon	
Das Ereignis ~ Die Events	Event	
Die Decke ~ Die Decken	Ceiling	
Der Motor ~ Die Motoren	Engine	
Das Geschenk ~ Die Geschenke	Gift	
Das Restaurant ~ Die Restaurants	Restaurant	
Die Tafel ~ Die Bretter	Board	
Der Flur ~ Die Flure	Hallway	
Die Armee ~ Die Armeen	Army	
Der Aufwand ~ Bemühungen	Effort	
Der Osten ~ Die Easts	East	
Der Agent ~ Die Mittel	Agent	
Die Zukunft ~ Die Futures	Future	
Die Hose ~ Die Hose	Pant	
Das Leder ~ Die Leder	Leather	
Der Flug ~ Die Flüge	Flight	
Das Geschlecht ~ Die Sexs	Sex	
Das Gericht ~ Die Gerichte	Court	
Der Kurs ~ Die Kurse	Course	
Der Dreck ~ Die Dirts	Dirt	
Das Ei ~ Die Eier	Egg	
Das Kinn ~ Die Kinne	Chin	
Der Fremde ~ Die Fremden	Stranger	
Die Freude ~ Die Freuden	Pleasure	
Das Detail ~ Die Details	Detail	
Die Besatzung ~ Die Besatzungen	Crew	
Der Herbst ~ Die Wasserfälle	Fall	
Der Gast ~ Die Gäste	Guest	
Das Erlebnis ~ Erfahrungen	Experience	
Der Witz ~ Die Witze	Joke	
Der Sand ~ Der Sand	Sand	
Die Faust ~ Die Fäuste	Fist	
Die Aktion ~ Die Aktionen	Action	
Das Wandern ~ Die Wanderungen	Walk	
Die Hochzeit ~ Die Hochzeiten	Wedding	
Der Deal ~ Die Angebote	Deal	
Die Natur ~ Die Natur	Nature	
Der Planet ~ Die Planeten	Planet	
Der Cousin ~ Die Cousinen	Cousin	
Die Bewegung ~ Die Bewegungen	Movement	
Das Fleisch ~ Die Konkretisiert	Flesh	
Der Datensatz ~ Datensätze	Record	
Das Camp ~ Die Lager	Camp	
Die Zeitung ~ Die Zeitung	Newspaper	
Der Strahl ~ Die Strahlen	Ray	
Der Mensch ~ Die Menschen	Human	
Das Sofa ~ Die Liegen	Couch	
Der Großvater ~ Die Großväter	Grandfather	
Die Fotografie ~ Die Photographes	Photograph	
Das Geheimnis ~ Geheimnisse	Secret	
Die Schönheit ~ Die Schönheiten	Beauty	
Das Vorhandensein ~ Die Präsenzen	Presence	
Die Glocke ~ Die Glocken	Bell	
Die Volks ~ Die Leute	Folk	
Der Knopf ~ Die Knöpfe	Button	
Die Liste ~ Die Listen	List	
Das Level ~ Die Niveaus	Level	
Das Datum ~ Die Daten	Date	
Das Thema ~ Die Fächer	Subject	
Der Unterschied ~ Die Unterschiede	Difference	
Die Pause ~ Die Pausen	Pause	
Der Van ~ Die Wagen	Van	
Die Klinge ~ Die Klingen	Blade	
Das Fernsehen ~ Die Fernseher	Television	
Die Titelseite ~ Die Abdeckungen	Cover	
Die Vergangenheit ~ Die Vergangenheit	Past	
Der Bauernhof ~ Die Bauernhöfe	Farm	
Die Runden ~ Die Runden	Lap	
Die Band ~ Die Bands	Band	
Der Anwalt ~ Die Anwälte	Lawyer	
Das Magazin ~ Die Zeitschriften	Magazine	
Der Ast ~ Die Zweige	Branch	
Der Rahmen ~ Die Rahmen	Frame	
Das Deck ~ Die Decks	Deck	
Der Effekt ~ Die Effekte	Effect	
Der Tanz ~ Die Tänze	Dance	
Die Sicht ~ Die Visionen	Vision	
Das Gespenst ~ Die Geister	Ghost	
Der Esel ~ Die Esel	Ass	
Der Charakter ~ Die Charaktere	Character	
Das Auf Wiedersehen ~ Die Verabschiedungen	GoodBye	
Das Park ~ Die Parkplätze	Parking	
Das Frühstück ~ Das Frühstück	Breakfast	
Die Geste ~ Die Gesten	Gesture	
Das Glück ~ Die Lucks	Luck	
Das Gas ~ Die Gase	Gas	
Der Korridor ~ Die Flure	Corridor	
Der Professor ~ Die Professoren	Professor	
Der Fehler ~ Die Fehler	Mistake	
Die Universität ~ Die Universitäten	University	
Der Ozean ~ Die Ozeane	Ocean	
Das Jahrhundert ~ Die Jahrhunderte	Century	
Der Honig ~ Honige	Honey	
Der Stapel ~ Die Pfähle	Pile	
Die Schale ~ Die Schalen	Bowl	
Basis ~ Die Basen	Base	
Der Zaun ~ Die Zäune	Fence	
Die Regel ~ Die Regeln	Rule	
Das Gelächter ~ Die Gelächter	Laughter	
Die Wut ~ Die Angers	Anger	
Der Schweiß ~ Die Schweißausbrüche	Sweat	
Der Unfall ~ Die Unfälle	Accident	
Das Wetter ~ Die Wind Und Wetter	Weather	
Die Entscheidung ~ Die Entscheidungen	Decision	
Der Engel ~ Die Engel	Angel	
Die Stärke ~ Die Stärken	Strength	
Das Huhn ~ Die Hühner	Chicken	
Die Studium ~ Die Studien	Study	
Das Band ~ Die Bänder	Tape	
Das Handgelenk ~ Die Handgelenke	Wrist	
Der Halt ~ Die Anschläge	Stop	
Die Hüfte ~ Die Hüften	Hip	
Die Regierung ~ Die Regierungen	Government	
Der Bauch ~ Die Bäuche	Belly	
Die Königin ~ Die Königinnen	Queen	
Bericht ~ Die Berichte	Report	
Der Schweif ~ Die Schwänze	Tail	
Die Pflanze ~ Die Pflanzen	Plant	
Die Flamme ~ Die Flammen	Flame	
Der Himmel ~ Die Himmel	Heaven	
Der Gürtel ~ Die Gürtel	Belt	
Die Nachbarschaft ~ Die Nachbarschaften	Neighborhood	
Die Energie ~ Die Energien	Energy	
Das Grün ~ Die Grünen	Green	
Das Viertel ~ Die Viertel	Quarter	
Der Feind ~ Die Feinde	Enemy	
Die Bewegung ~ Die Züge	Move	
Der Eingang ~ Die Zugänge	Entrance	
Die Bibliothek ~ Die Bibliotheken	Library	
Der Verfasser ~ Die Autoren	Writer	
Der Frieden ~ Die Peaces	Peace	
Die Berührung ~ Die Berührungen	Touch	
Der Topf ~ Die Töpfe	Pot	
Der Typ ~ Die Typen	Type	
Das Seil ~ Die Seile	Rope	
Der Muskel ~ Die Muskeln	Muscle	
Das Gemälde ~ Die Gemälde	Painting	
Die Gardine ~ Die Vorhänge	Curtain	
Die Mahlzeit ~ Die Essen	Meal	
Der Akt ~ Die Handlungen	Act	
Der Wolf ~ Die Wölfe	Wolf	
Die Kajüte ~ Die Kabinen	Cabin	
Die Ladung ~ Die Ladungen	Charge	
Der Passagier ~ Die Passagiere	Passenger	
Der Kumpel ~ Die Freunde	Buddy	
Das Medikament ~ Die Arzneimittel	Drug	
Die Verwendung ~ Die Verwendungen	Use	
Die Bank ~ Die Bänke	Bench	
Der Verkehr ~ Die Verkehre	Traffic	
Das Relief ~ Die Reliefs	Relief	
Die Kappe ~ Die Kappen	Cap	
Das Rudel ~ Die Packungen	Pack	
Das Wochenende ~ Die Wochenenden	Weekend	
Der Stand ~ Die Stände	Stand	
Der Aufzug ~ Die Aufzüge	Elevator	
Der Geburtstag ~ Die Geburtstage	Birthday	
Die Lilie ~ Die Lilien	Lily	
Das Bügeleisen ~ Die Eisen	Iron	
Das Fleisch ~ Das Fleisch	Meat	
Die Augenbraue ~ Die Augenbrauen	Eyebrow	
Die Geschwindigkeit ~ Die Geschwindigkeiten	Speed	
Die Absicht ~ Die Zwecke	Purpose	
Der Rock ~ Die Röcke	Skirt	
Das Quadrat ~ Die Quadrate	Square	
Die Fahrt ~ Die Antriebe	Drive	
Den Artikel ~ Die Artikel	Article	
Das Englisch ~ Die Englishes	English	
Der Turm ~ Die Türme	Tower	
Der Kampf ~ Die Schlachten	Battle	
Der Film ~ Die Filme	Film	
Das Rennen ~ Die Rennen	Race	
Der Schock ~ Die Schocks	Shock	
Die Sektion ~ Die Abschnitte	Section	
Die Methode ~ Die Sitten	Manner	
Das Schwert ~ Die Schwerter	Sword	
Der Stock ~ Die Stöcke	Stick	
Die Datei ~ Die Dateien	File	
Das Brot ~ Die Brote	Bread	
Das Öl ~ Die Öle	Oil	
Die Kette ~ Die Ketten	Chain	
Die Abteilung ~ Die Abteilungen	Department	
Projekt ~ Die Projekte	Project	
Der Mord ~ Die Morde	Murder	
Der Bär ~ Die Bären	Bear	
Der Test ~ Die Tests	Test	
Der Besuch ~ Die Besuche	Visit	
Die Milch ~ Die Milch	Milk	
Der Chef ~ Die Bosse	Boss	
Der Ellbogen ~ Die Ellbogen	Elbow	
Das Verlangen ~ Die Wünsche	Desire	
Der Patient ~ Die Patienten	Patient	
Das Grinsen ~ Die Grins	Grin	
Der Liebhaber ~ Die Liebhaber	Lover	
Der Preis ~ Die Preise	Price	
Das Wissen ~ Die Erkenntnisse	Knowledge	
Der Anfang ~ Die Anfänge	Beginning	
Die Kälte ~ Die Erkältung	Cold	
Der Schrank ~ Die Schränke	Closet	
Die Morgendämmerung ~ Im Morgengrauen	Dawn	
Der Tempel ~ Die Tempel	Temple	
Der Spaß ~ Die Freuden	Joy	
Die Pflicht ~ Die Aufgaben	Duty	
Die Übung ~ Die Praktiken	Practice	
Die Ferse ~ Die Fersen	Heel	
Das Tal ~ Die Täler	Valley	
Der Kampf ~ Die Kämpfe	Fight	
Das Kabel ~ Die Drähte	Wire	
Die Jeans ~ Die Jeanses	Jeans	
Der Kuss ~ Die Küsse	Kiss	
Der Kiefer ~ Die Backen	Jaw	
Die Lauf ~ Die Läufe	Run	
Der Halt ~ Die Laderäume	Hold	
Das Verhältnis ~ Die Beziehungen	Relationship	
Das Objekt ~ Die Objekte	Object	
Der Angriff ~ Die Angriffe	Attack	
Das Gericht ~ Das Geschirr	Dish	
Die Autobahn ~ Die Autobahnen	Highway	
Die Schattierung ~ Die Schatten	Shade	
Das Verbrechen ~ Die Verbrechen	Crime	
Das Weiß ~ Die Weißen	White	
Der Partner ~ Die Partner	Partner	
Der Priester ~ Die Priester	Priest	
Der Rasen ~ Der Rasen	Lawn	
Das Lachen ~ Die Lachen	Laugh	
Der Kofferraum ~ Die Stämme	Trunk	
Das Weinen ~ Die Schreie	Cry	
Das Programm ~ Die Programme	Program	
Die Fahrt ~ Die Fahrten	Ride	
Das Regal ~ Die Regale	Shelf	
Der Gentleman ~ The Gentlemans	Gentleman	
Das Sein ~ Die Wesen	Being	
Der Stahl ~ Die Stähle	Steel	
Der Bürgersteig ~ Die Bürgersteige	Sidewalk	
Die Uniform ~ Die Uniformen	Uniform	
Das Muster ~ Die Muster	Pattern	
Der Beweis ~ Die Beweise	Evidence	
Der Spieler ~ Die Spieler	Player	
Der Roman ~ Die Romane	Novel	
Das Kissen ~ Die Kissen	Pillow	
Die Lampe ~ Die Lampen	Lamp	
Die Schublade ~ Die Schubladen	Drawer	
Die Gefahr ~ Die Gefahren	Danger	
Der Detektiv ~ Die Detektive	Detective	
Die Instant ~ Die Zeitpunkte	Instant	
Das Denken ~ Die Gedanken	Thinking	
Der Riss ~ Die Risse	Crack	
Das Gebet ~ Die Gebete	Prayer	
Das Handtuch ~ Die Handtücher	Towel	
Der Handschuh ~ Die Handschuhe	Glove	
Die Bucht ~ Die Buchten	Bay	
Das Publikum ~ Das Publikum	Audience	
Die Dose ~ Die Dosen	Can	
Die Bedingung ~ Die Bedingungen	Condition	
Der Pfad ~ Die Wanderwege	Trail	
Die Taille ~ Die Taille	Waist	
Der Druck ~ Die Drücke	Pressure	
Das Waschbecken ~ Die Waschbecken	Sink	
Die Rückkehr ~ Die Renditen	Return	
Die Brise ~ Die Lüfte	Breeze	
Der Geschmack ~ Die Geschmäcker	Taste	
Der Strom ~ Bäche	Stream	
Das Ergebnis ~ Die Ergebnisse	Result	
Der Autor ~ Die Autoren	Author	
Das Trinkgeld ~ Die Spitzen	Tip	
Die Dusche ~ Die Duschen	Shower	
Die Zehe ~ Die Zehen	Toe	
Die Jahreszeit ~ Die Jahreszeiten	Season	
Die Hälfte ~ Die Hälften	Half	
Der Dummkopf ~ Die Narren	Fool	
Der Tunnel ~ Die Tunnel	Tunnel	
Der Klient ~ Die Clients	Client	
Die Garage ~ Die Garagen	Garage	
Die Mission ~ Die Missionen	Mission	
Der Chef ~ Die Häuptlinge	Chief	
Die Kugel ~ Die Kugeln	Bullet	
Der Markt ~ Die Märkte	Market	
Der Verlust ~ Die Verluste	Loss	
Die Reihe ~ Die Serieses	Series	
Der Stift ~ Die Stifte	Pen	
Der Begriff ~ Die Begriffe	Term	
Das Gedicht ~ Die Gedichte	Poem	
Der Prinz ~ Die Fürsten	Prince	
Der Ton ~ Die Tone	Clay	
Das Schloss ~ Die Schlösser	Lock	
Die Realität ~ Die Wirklichkeiten	Reality	
Die Schlange ~ Die Schlangen	Snake	
Der Apfel ~ Die Äpfel	Apple	
Die Maske ~ Die Masken	Mask	
Dem Kunden ~ Die Kunden	Customer	
Die Geburt ~ Die Geburten	Birth	
Das Wunder ~ Wunder	Wonder	
Das Sonnenlicht ~ Die Sunlights	Sunlight	
Der Panzer ~ Die Tanks	Tank	
Das Personal ~ Die Mitarbeiter	Staff	
Die Lüge ~ Die Lügen	Lie	
Der Glaube ~ Die Glaubensrichtungen	Faith	
Die Ehre ~ Ehrungen	Honor	
Die Creme ~ Die Cremes	Cream	
Das Wohl ~ Die Willen	Sake	
Das Opfer ~ Die Opfer	Victim	
Die Möglichkeit ~ Die Möglichkeiten	Possibility	
Der Kontakt ~ Die Kontakte	Contact	
Die Stimmung ~ Die Stimmungen	Mood	
Der Daumen ~ Die Daumen	Thumb	
Das Lesen ~ Die Messwerte	Reading	
Der Spaß ~ Die Funs	Fun	
Die Kerze ~ Die Kerzen	Candle	
Die Höhle ~ Die Höhlen	Cave	
Die Post ~ Die Pfosten	Post	
Das Gefängnis ~ Die Gefängnisse	Prison	
Die Emotion ~ Die Emotionen	Emotion	
Der Führer ~ Die Führer	Leader	
Der Grad ~ Grade	Degree	
Die Eigenschaft ~ Die Funktionen	Feature	
Das Ticket ~ Die Tickets	Ticket	
Das Alien ~ Die Aliens	Alien	
Der Unterricht ~ Die Stunden	Lesson	
Die Wüste ~ Die Wüsten	Desert	
Der Schnitt ~ Die Schnitte	Cut	
Die Unordnung ~ Die Kasinos	Mess	
Die Warnung ~ Die Warnungen	Warning	
Das Märchen ~ Die Geschichten	Tale	
Das Begräbnis ~ Die Beerdigungen	Funeral	
Das Taxi ~ Die Kabinen	Cab	
Der Reporter ~ Die Reporter	Reporter	
Das Theater ~ Die Theater	Theater	
Die Länge ~ Die Längen	Length	
Der Schlamm ~ Die Schlämme	Mud	
Die Wissenschaft ~ Die Wissenschaften	Science	
Der Fall ~ Die Tropfen	Drop	
Die Schnur ~ Die Streicher	String	
Die Rede ~ Die Reden	Speech	
Die Kopie ~ Die Kopien	Copy	
Die Kuh ~ Die Kühe	Cow	
Der Arbeiter ~ Die Arbeiter	Worker	
Der Oberschenkel ~ Die Thighes	Thigh	
Das Labor ~ Die Labore	Lab	
Die Rolle ~ Die Walzen	Roll	
Das Obst ~ Die Früchte	Fruit	
Der Patch ~ Die Patches	Patch	
Die Seide ~ Die Seide	Silk	
Der Buck ~ Die Böcke	Buck	
Die Ziegel ~ Die Ziegel	Brick	
Das Gewehr ~ Die Gewehre	Rifle	
Die Karriere ~ Die Karrieren	Career	
Das Thema ~ Die Probleme	Issue	
Die Gelegenheit ~ Die Chancen	Opportunity	
Der Direktor ~ Die Direktoren	Director	
Das Monster ~ Die Monster	Monster	
Das Fahrzeug ~ Die Fahrzeuge	Vehicle	
Die Gasse ~ Die Gassen	Alley	
Die Hülse ~ Die Ärmel	Sleeve	
Das Grab ~ Die Gräber	Grave	
Der Busch ~ Die Büsche	Bush	
Der Speisesaal ~ Die Dinings	Dining	
Die Eröffnung ~ Die Öffnungen	Opening	
Der Zwilling ~ Die Zwillinge	Twin	
Die Scheune ~ Die Scheunen	Barn	
Das Pfund ~ Die Pfunde	Pound	
Der Standort ~ Die Websites	Site	
Der Blitz ~ Die Blitze	Flash	
Der Richter ~ Die Richter	Judge	
Die Masse ~ Die Massen	Mass	
Der Prozess ~ Die Prozesse	Process	
Das Band ~ Die Bande	Tie	
Der Geldbeutel ~ Die Geldbeutel	Purse	
Das Rohr ~ Die Röhren	Pipe	
Der Drache ~ Die Drachen	Dragon	
Der Horizont ~ Die Horizonte	Horizon	
Die Schale ~ Die Traies	Tray	
Der Umschlag ~ Die Umschläge	Envelope	
Die Prüfung ~ Die Kontrollen	Check	
Die Erwachsene ~ Die Erwachsenen	Adult	
Der Notfall ~ Die Emergencys	Emergency	
Das Material ~ Die Materialien	Material	
Die Kindheit ~ Die Kindheit	Childhood	
Die Angewohnheit ~ Die Gewohnheiten	Habit	
Der Künstler ~ Die Artisten	Artist	
Die Adresse ~ Die Adressen	Address	
Der Duft ~ Die Düfte	Scent	
Das Universum ~ Die Universen	Universe	
Das Kopfnicken ~ Die Nickt	Nod	
Die Muschel ~ Die Schalen	Shell	
Die Gemeinde ~ Die Gemeinden	Community	
Der Anfang ~ Beginnt Der	Start	
Die Wunde ~ Die Wunden	Wound	
Die Maus ~ Die Mäuse	Mouse	
Der Pilot ~ Die Piloten	Pilot	
Die Klasse ~ Die Noten	Grade	
Das Video ~ Die Videos	Video	
Der Korb ~ Die Körbe	Basket	
Der Wagen ~ Die Wagen	Wagon	
Der Versuch ~ Die Versuche	Attempt	
Das Sofa ~ Die Sofas	Sofa	
Der Kuchen ~ Die Kuchen	Cake	
Die Affäre ~ Die Angelegenheiten	Affair	
Die Küste ~ Die Ufer	Shore	
Die Allgemeine ~ Die Generäle	General	
Der Ursprung ~ Die Wurzeln	Root	
Die Robe ~ Die Gewänder	Robe	
Die Sorge ~ Die Bedenken	Concern	
Die Presse ~ Die Pressen	Press	
Die Ratte ~ Die Ratten	Rat	
Die Gesellschaft ~ Die Gesellschaften	Society	
Der Stil ~ Die Stile	Style	
Die Kreis ~ Die Landkreise	County	
Der Befehl ~ Die Befehle	Command	
Der Besucher ~ Die Besucher	Visitor	
Das Model ~ Die Modelle	Model	
Die Kammer ~ Die Kammern	Chamber	
Das Biest ~ Die Tiere	Beast	
Das Bündel ~ Die Trauben	Bunch	
Der Hintergrund ~ Die Hintergründe	Background	
Die Einheit ~ Die Einheiten	Unit	
Die Möbel ~ Die Möbel	Furniture	
Der Nagel ~ Die Nägel	Nail	
Der Schrei ~ Die Schreie	Scream	
Die Eigenschaft ~ Eigenschaften	Property	
Die Ausrüstung ~ Die Ausrüstungen	Equipment	
Die Auffahrt ~ Die Einfahrten	Driveway	
Der Griff ~ Die Griffe	Grip	
Die Asche ~ Die Asche	Ash	
Der Fan ~ Die Fans	Fan	
Die Meinung ~ Die Ansichten	Opinion	
Die Daten ~ Die Daten	Data	
Die Verbindung ~ Die Verbindungen	Connection	
Der Trick ~ Die Tricks	Trick	
Das Mysterium ~ Die Geheimnisse	Mystery	
Die Periode ~ Die Perioden	Period	
Das Schreiben ~ Die Schriften	Writing	
Der Horror ~ Die Schrecken	Horror	
Die Süßigkeit ~ Die Bonbons	Candy	
Die Bitch ~ Die Hündinnen	Bitch	
Die Gesundheit ~ Die Healths	Health	
Der Geschäftsführer ~ Die Manager	Manager	
Die Sicherheit ~ Die Sicherheiten	Safety	
Die Höhe ~ Die Höhen	Height	
Die Erscheinung ~ Die Erscheinungen	Appearance	
Der Seufzer ~ Die Sighes	Sigh	
Die Mine ~ Die Bergwerke	Mine	
Die Kleidung ~ Die Tücher	Cloth	
Die Reaktion ~ Die Reaktionen	Reaction	
Die Quelle ~ Die Quellen	Source	
Das Ich ~ Die Selfs	Self	
Die Pistole ~ Die Pistolen	Pistol	
Der Flughafen ~ Die Flughäfen	Airport	
Der Held ~ Die Helden	Hero	
Das Versprechen ~ Die Versprechen	Promise	
Der Bogen ~ Die Bögen	Bow	
Das Zelt ~ Die Zelte	Tent	
Der Messestand ~ Die Stände	Booth	
Das Geld ~ Die Kassen	Cash	
Die Straße ~ Die Alleen	Avenue	
Das TShirt ~ Die TShirts	TShirt	
Der Teppich ~ Die Teppiche	Carpet	
Der Keller ~ Die Keller	Basement	
Die Freundin ~ Die Freundinnen	Girlfriend	
Der Bart ~ Die Bärte	Beard	
Die Stirn ~ Die Augenbrauen	Brow	
Der Bildschirm ~ Die Anzeigen	Display	
Das Signal ~ Die Signale	Signal	
Der Diener ~ Die Diener	Servant	
Das Flüstern ~ Das Flüstern	Whisper	
Der Zweifel ~ Die Zweifel	Doubt	
Das Konto ~ Die Accounts	Account	
Die Magie ~ Die Magie	Magic	
Die Hank ~ Die Stränge	Hank	
Das Glied ~ Die Schenkel	Limb	
Der Bastard ~ Die Bastarde	Bastard	
Der Schädel ~ Die Schädel	Skull	
Der Kragen ~ Die Kragen	Collar	
Das Horn ~ Die Hörner	Horn	
Die Eiche ~ Die Eichen	Oak	
Der Knöchel ~ Die Knöchel	Ankle	
Die Puppe ~ Die Puppen	Doll	
Das Sandwich ~ Die Sandwiches	Sandwich	
Das Rotkehlchen ~ Die Rotkehlchen	Robin	
Die Justiz ~ Die Richter	Justice	
Der Stolz ~ Die Rudel	Pride	
Die Jugend ~ Die Jugendlichen	Youth	
Der Sekretär ~ Die Sekretäre	Secretary	
Die Forschung ~ Die Forschungen	Research	
Der Sport ~ Die Sport	Sport	
Die Aufgabe ~ Die Aufgaben	Task	
Der Zuschuss ~ Die Zuschüsse	Grant	
Der Sheriff ~ Die Sheriffs	Sheriff	
Die Mitternachts ~ Die Mitternächte	Midnight	
Der Chip ~ Die Chips	Chip	
Die Theorie ~ Theorien	Theory	
Den Wecker ~ Die Alarme	Alarm	
Die Sammlung ~ Die Sammlungen	Collection	
Das Kreuz ~ Die Kreuze	Cross	
Die Kiefer ~ Die Kiefern	Pine	
Die Generation ~ Die Generationen	Generation	
Die Autorität ~ Die Behörden	Authority	
Die Papa ~ Die Papas	Papa	
Die Reise ~ Die Reisen	Journey	
Die Perle ~ Die Perlen	Pearl	
Die Toilette ~ Die Toiletten	Toilet	
Der Mörder ~ Die Mörder	Killer	
Das Werkzeug ~ Die Werkzeuge	Tool	
Die Medizin ~ Die Medikamente	Medicine	
Der Zucker ~ Die Zucker	Sugar	
Die Prinzessin ~ Die Prinzessinnen	Princess	
Das Argument ~ Die Argumente	Argument	
Die Klippe ~ Die Klippen	Cliff	
Der Kristall ~ Die Kristalle	Crystal	
Die Bohne ~ Die Bohnen	Bean	
Der Käfig ~ Die Käfige	Cage	
Die Schokolade ~ Die Pralinen	Chocolate	
Die Küste ~ Die Küsten	Coast	
Das Jahrzehnt ~ Die Jahrzehnte	Decade	
Die Bedeutung ~ Die Bedeutungen	Meaning	
Das Getriebe ~ Die Zahnräder	Gear	
Der Koffer ~ Die Koffer	Suitcase	
Die Operation ~ Die Operationen	Operation	
Das Atem ~ Die Breathings	Breathing	
Die Rolle ~ Die Rollen	Role	
Die Version ~ Fassungen	Version	
Der Gefangene ~ Die Gefangenen	Prisoner	
Das Match ~ Die Spiele	Match	
Die Burg ~ Die Schlösser	Castle	
Der Ansturm ~ Die Binsen	Rush	
Die Fahrspur ~ Die Bahnen	Lane	
Die Bekleidung ~ Die Garnituren	Clothing	
Der Pol ~ Die Pole	Pole	
Die Freiheit ~ Die Freiheiten	Freedom	
Das Können ~ Die Fähigkeiten	Skill	
Die Leidenschaft ~ Die Leidenschaften	Passion	
Die Aktivität ~ Die Aktivitäten	Activity	
Zum Teufel ~ Die Fickt	Fuck	
Die Platform ~ Die Plattformen	Platform	
Das Salz ~ Die Salze	Salt	
Das Fahrrad ~ Die Fahrräder	Bike	
Der Stapel ~ Die Stapel	Stack	
Der Begleiter ~ Die Gefährten	Companion	
Das Schicksal ~ Die Schicksale	Fate	
Die Wut ~ Die Wütet	Rage	
Die Versorgung ~ Die Lieferungen	Supply	
Der Wal ~ Die Wale	Whale	
Das Schwein ~ Die Schweine	Pig	
Der Hase ~ Die Hasen	Rabbit	
Der Gang ~ Die Gänge	Aisle	
Der Bildschirm ~ Die Monitore	Monitor	
Der Helm ~ Die Helme	Helmet	
Der Respekt ~ Die Beziehung	Respect	
Die Aufregung ~ Die Aufregungen	Excitement	
Die Lobby ~ Die Lobbys	Lobby	
Das Fell ~ Die Felle	Fur	
Der Bereich ~ Die Bereiche	Range	
Die Dick ~ Die Schwänze	Dick	
Der Code ~ Die Codes	Code	
Das Kapitel ~ Die Kapitel	Chapter	
Die Reflexion ~ Die Reflexionen	Reflection	
Die Post ~ Die EMails	Mail	
Der Flug ~ Die Fliegen	Fly	
Das Kabinett ~ Die Schränke	Cabinet	
Das Spielzeug ~ Die Spielzeuge	Toy	
Die Baseball ~ The Baseballs	Baseball	
Das Innere ~ Die Innenseiten	Inside	
Die Geschwindigkeit ~ Die Schritte	Pace	
Die Führung ~ Die Zuleitungen	Lead	
Die Summe ~ Die Beträge	Amount	
Der Nerv ~ Die Nerven	Nerve	
Der Schrecken ~ Die Schrecken	Terror	
Der Pullover ~ Die Pullover	Sweater	
Die Qualität ~ Die Qualitäten	Quality	
Der Jäger ~ Die Jäger	Hunter	
Die Farbe ~ Die Anstriche	Paint	
Die Buster ~ The Busters	Buster	
Die Baumwolle ~ Die Baumwollstoffe	Cotton	
Der Wachtmeister ~ Die Feldwebel	Sergeant	
Der Kredit ~ Die Kredite	Credit	
Der Schlag ~ Die Schläge	Blow	
Der Teufel ~ Die Teufel	Devil	
Die Bedrohung ~ Die Drohungen	Threat	
Der Erfolg ~ Erfolge	Success	
Dem Vorabend ~ Die Eves	Eve	
Das Kabel ~ Die Kabel	Cable	
Die Pfanne ~ Die Pfannen	Pan	
Der Angestellte ~ Die Schreiber	Clerk	
Den Titel ~ Die Titel	Title	
Das Messgerät ~ Die Zähler	Meter	
Die Schande ~ Die Schande	Shame	
Die Nadel ~ Die Nadeln	Needle	
Die Lunge ~ Die Lungen	Lung	
Der Krieger ~ Die Krieger	Warrior	
Der Umstand ~ Die Umstände	Circumstance	
Das Studio ~ Die Studios	Studio	
Die Panik ~ Die Panik	Panic	
Der Mangel ~ Das Fehlt	Lack	
Der Bauer ~ Die Bauern	Farmer	
Der Akzent ~ Die Akzente	Accent	
Die Bombe ~ Die Bomben	Bomb	
Die Platte ~ Die Paneele	Panel	
Die Fähigkeit ~ Die Das Können	Ability	
Das Glück ~ Die Geschicke	Fortune	
Der Sieger ~ Die Sieger	Victor	
Die Feder ~ Die Federn	Feather	
Die Oma ~ Die Großmütter	Grandma	
Das Glühen ~ Die Glüht	Glow	
Das Verhalten ~ Die Verhaltensweisen	Behavior	
Der Durchgang ~ Die Durchgänge	Passage	
Die Slave ~ Die Sklaven	Slave	
Der Leutnant ~ Die Leutnants	Lieutenant	
Der Lauf ~ Die Fässer	Barrel	
Die Wärme ~ Die Warmths	Warmth	
Der Eindruck ~ Die Eindrücke	Impression	
Der Maurer ~ Die Maurer	Mason	
Die Braut ~ Die Bräute	Bride	
Das Paket ~ Die Pakete	Package	
Der Nebel ~ Die Nebel	Fog	
Das Gehen ~ Die Wanderungen	Walking	
Die Balance ~ Die Salden	Balance	
Die Socke ~ Die Socken	Sock	
Der Roboter ~ Die Roboter	Robot	
Die Kartoffel ~ Die Kartoffeln	Potato	
Der Gegenstand ~ Die Gegenstände	Item	
Das Bad ~ Die Bäder	Bath	
Der Diamant ~ Die Diamanten	Diamond	
Die Leiche ~ Die Leichen	Corpse	
Die Erklärung ~ Die Erläuterungen	Explanation	
Die Struktur ~ Die Strukturen	Structure	
Der Ausgang ~ Die Ausgänge	Exit	
Das Pad ~ Die Pads	Pad	
Der Herd ~ Die Öfen	Stove	
Das Blaue ~ Der Blues	Blue	
Die Amerikaner ~ Die Amerikaner	American	
Der Rubin ~ Die Rubinen	Ruby	
Der Blitz ~ Blitze	Lightning	
Die Grube ~ Die Gruben	Pit	
Der Oberst ~ Die Obersten	Colonel	
Das Dock ~ Die Docks	Dock	
Der Bach ~ Die Bäche	Creek	
Der Ratschlag ~ Die Ratschläge	Advice	
Der Tourist ~ Die Touristen	Tourist	
Die Trauer ~ Die Schmerzen	Grief	
Die Verteidigung ~ Die Abwehrkräfte	Defense	
Der Biss ~ Die Bisse	Bite	
Das Museum ~ Die Museen	Museum	
Die Gunst ~ Wohltaten	Favor	
Der Komfort ~ Komfort	Comfort	
Der Dekan ~ Die Dekane	Dean	
Der Wert ~ Die Werte	Value	
Der Marsch ~ Die Märsche	March	
Das Anwesen ~ Die Stände	Estate	
Der Poet ~ Die Dichter	Poet	
Der Palast ~ Die Paläste	Palace	
Die Suppe ~ Die Suppen	Soup	
Die Nation ~ Die Nationen	Nation	
Das Gefäss ~ Die Gläser	Jar	
Der Ständige ~ Die Tabellenführung	Standing	
Der Sack ~ Die Säcke	Sack	
Der Dämon ~ Die Dämonen	Demon	
Die Konferenz ~ Die Konferenzen	Conference	
Der Saft ~ Die Säfte	Juice	
Die Verantwortung ~ Die Zuständigkeiten	Responsibility	
Der Pinsel ~ Die Bürsten	Brush	
Die Route ~ Die Strecken	Route	
Der Käse ~ Die Käse	Cheese	
Die Haube ~ Die Hauben	Hood	
Die Ente ~ Die Ente	Duck	
Der Heilige ~ Die Heiligen	Saint	
Der Pass ~ Die Pässe	Pass	
Das Ziel ~ Die Ziele	Target	
Die Orange ~ Die Orangen	Orange	
Die Kultur ~ Die Kulturen	Culture	
Die Reise ~ Die Touren	Tour	
Der Kommandant ~ Die Kommandeure	Commander	
Der Haken ~ Die Haken	Hook	
Das Training ~ Die Trainings	Training	
Die Suche ~ Die Suche	Search	
Die Münze ~ Die Münzen	Coin	
Das Wunder ~ Die Wunder	Miracle	
Der Vorteil ~ Die Vorteile	Advantage	
Der Austausch ~ Die Börsen	Exchange	
Die Fiktion ~ Fiktionen	Fiction	
Der Teich ~ Die Teiche	Pond	
Der Assistent ~ Die Assistenten	Assistant	
Das Design ~ Die Entwürfe	Design	
Die Angel ~ Die Fishings	Fishing	
Die Piste ~ Die Pisten	Slope	
Der Graf ~ Die Grafen	Earl	
Kommentar ~ Kommentare	Comment	
Der Kellner ~ Die Kellner	Waiter	
Von Lebensmittel ~ Die Lebensmittel	Grocery	
Die Leiter ~ Die Leitern	Ladder	
Die Kurve ~ Die Kurven	Curve	
Das Volumen ~ Die Volumina	Volume	
Das Risiko ~ Die Risiken	Risk	
Der Albtraum ~ Die Alpträume	Nightmare	
Die Existenz ~ Die Existenzen	Existence	
Die Spur ~ Die Spuren	Trace	
Die Krankheit ~ Die Krankheiten	Disease	
Die Unterstützung ~ Die Stützen	Support	
Der Zeuge ~ Die Zeugen	Witness	
Die Aktie ~ Die Bestände	Stock	
Das Gerät ~ Die Vorrichtungen	Device	
Die Landschaft ~ Die Landschaften	Landscape	
Der Urlaub ~ Die Feiertage	Holiday	
Das Ass ~ Die Asse	Ace	
Das Klavier ~ Die Klaviere	Piano	
Die Eingeweide ~ Die Eingeweide	Gut	
Das Talent ~ Die Talente	Talent	
Die Phantasie ~ Die Vorstellungen	Imagination	
Die Schwarze ~ Die Schwarzen	Black	
Der Reed ~ Das Schilf	Reed	
Der Deckel ~ Die Deckel	Lid	
Der Hinweis ~ Die Hinweise	Hint	
Der Wanderer ~ Die Wanderer	Walker	
Die Kälte ~ Schüttelfrost	Chill	
Die Studie ~ Die Prüfungen	Trial	
Das Interview ~ Die Interviews	Interview	
Der Ansatz ~ Die Ansätze	Approach	
Die Narbe ~ Die Narben	Scar	
Die Mode ~ Die Mode	Fashion	
Der Kanal ~ Die Kanäle	Channel	
Die Tritt ~ Die Schritte	Footstep	
Der Aufnehmer ~ Die Pickups	Pickup	
Der Habicht ~ Die Falken	Hawk	
Der Anhänger ~ Die Anhänger	Trailer	
Die Statue ~ Die Statuen	Statue	
Die Pille ~ Die Pillen	Pill	
Der Käfer ~ Die Bugs	Bug	
Der Eimer ~ Die Eimer	Bucket	
Den Urlaub ~ Die Urlaub	Vacation	
Die Arten ~ Die Specieses	Species	
Die Kolumne ~ Die Spalten	Column	
Der Schaden ~ Die Schäden	Damage	
Das Instrument ~ Die Instrumente	Instrument	
Der Hafen ~ Die Ports	Port	
Die Schicht ~ Die Schichten	Layer	
Der Streifen ~ Die Streifen	Strip	
Der Müll ~ Die Garbages	Garbage	
Die Rippe ~ Die Rippen	Rib	
Das Notebook ~ Die Notizbücher	Notebook	
Der Mais ~ Die Hühneraugen	Corn	
Das Angebot ~ Die Angebote	Offer	
Die Zeichnung ~ Die Zeichnungen	Drawing	
Die Aussage ~ Die Aussagen	Statement	
Die Intelligenz ~ Die Intelligenzen	Intelligence	
Die Entschuldigung ~ Die Ausreden	Excuse	
Die Landung ~ Die Landungen	Landing	
Der Urheberrechts ~ Die Urheberrechte	Copyright	
Die Stange ~ Die Stäbe	Rod	
Die Fantasie ~ Die Phantasien	Fantasy	
Die Neugier ~ Die Kuriositäten	Curiosity	
Die Grenze ~ Die Grenzen	Border	
Die Poesie ~ Die Dichtungen	Poetry	
Die Firma ~ Die Firmen	Firm	
Der Aufgang ~ Der Anstieg	Rise	
Die Handvoll ~ Die Hände Voll	Handful	
Die China ~ Die Chinas	China	
Die Franzosen ~ Die Frenches	French	
Die Durchschnitts ~ Die Mittel	Mean	
Das Reh ~ Die Hirsche	Deer	
Die Druck ~ Die Drucke	Print	
Die Schiene ~ Die Schienen	Rail	
Die Rate ~ Die Preise	Rate	
Der Mut ~ Die Courages	Courage	
Die Ankunft ~ Die Ankünfte	Arrival	
Der Wunsch ~ Wünsche	Wish	
Der Grat ~ Die Grate	Ridge	
Der Idiot ~ Die Idioten	Idiot	
Der Bulle ~ Die Bullen	Bull	
Die Saat ~ Die Samen	Seed	
Der Fortschritt ~ Die Fortschritte	Progress	
Das Gefühl ~ Es Fühlt Sich An	Feel	
Die Shorts ~ Die Shortses	Shorts	
Der Bürger ~ Die Bürger	Citizen	
Der Müll ~ Die Trashes	Trash	
Das Protokoll ~ Die Protokolle	Log	
Die Geduld ~ Die Patiencen	Patience	
Die Fledermaus ~ Die Fledermäuse	Bat	
Der Fußball ~ Die Fußbälle	Football	
Die Routine ~ Die Routinen	Routine	
Die Explosion ~ Die Explosionen	Explosion	
Der Inhalt ~ Die Inhalte	Content	
Der Wissenschaftler ~ Die Wissenschaftler	Scientist	
Das Versagen ~ Die Ausfälle	Failure	
Die Sünde ~ Die Sünden	Sin	
Der Hintern ~ Die Füße	Butt	
Die Verwirrung ~ Die Verwirrungen	Confusion	
Das Verständnis ~ Die Absprachen	Understanding	
Der Handel ~ Das Handwerk	Trade	
Der Kühlschrank ~ Die Kühlschränke	Refrigerator	
Der Herr ~ Die Misters	Mister	
Die Taschenlampe ~ Die Taschenlampen	Flashlight	
Das Internet ~ Die Netze	Net	
Der Seemann ~ Die Matrosen	Sailor	
Die Attitüde ~ Die Haltungen	Attitude	
Die Schuld ~ Die Schuldgefühle	Guilt	
Das Weinen ~ Die Geschrei	Crying	
Die Sip ~ Sips	Sip	
Der Keks ~ Die Kekse	Cookie	
Die Flucht ~ Die Fluchten	Escape	
Die Anleitung ~ Die Anleitungen	Instruction	
Das Gewebe ~ Die Stoffe	Fabric	
Der Marmor ~ Die Murmeln	Marble	
Der Blick ~ Die Einblicke	Glimpse	
Die Dämmerung ~ Die Dämmerungen	Dusk	
Die Hütte ~ Die Ferienhäuser	Cottage	
Der Affe ~ Die Affen	Monkey	
Das Makeup ~ Die MakeUps	Makeup	
Die Doc ~ Die Docs	Doc	
Die Bluse ~ Die Blusen	Blouse	
Der Rhythmus ~ Die Rhythmen	Rhythm	
Der Dampf ~ Die Dämpfe	Steam	
Der Satz ~ Die Phrasen	Phrase	
Die Mutter ~ Die Muttern	Nut	
Der Bleistift ~ Die Stifte	Pencil	
Der Koch ~ Die Köche	Cook	
Die Flagge ~ Die Fahnen	Flag	
Der Trainer ~ Die Trainer	Coach	
Die Schaukel ~ Die Schaukeln	Swing	
Der Lautsprecher ~ Die Lautsprecher	Speaker	
Der Bolzen ~ Die Bolzen	Bolt	
Das Fett ~ Die Fette	Fat	
Die Klopf ~ Die Schläge	Knock	
Der Zauber ~ Die Zaubersprüche	Spell	
Das Taxi ~ Die Taxis	Taxi	
Die Runde ~ Die Runden	Round	
Der Strohhalm ~ Die Halme	Straw	
Die Luke ~ Die Luken	Hatch	
Die Gabel ~ Die Gabeln	Fork	
Das Böse ~ Die Übel	Evil	
Das Dienstmädchen ~ Die Zimmermädchen	Maid	
Die Relative ~ Die Verwandten	Relative	
Die Hexe ~ Die Hexen	Witch	
Der Hof ~ Die Höfe	Courtyard	
Die Sensation ~ Die Empfindungen	Sensation	
Die Blase ~ Die Blasen	Bubble	
Der Leser ~ Die Leser	Reader	
Die Locke ~ Die Locken	Curl	
Der Kuchen ~ Die Torten	Pie	
Der Strahl ~ Die Jets	Jet	
Die Verschiebung ~ Die Verschiebungen	Shift	
Die Union ~ Die Gewerkschaften	Union	
Der Teenager ~ Die Teenager	Teenager	
Die Ebene ~ Die Ebenen	Plain	
Die Kellnerin ~ Die Kellnerinnen	Waitress	
Das Gerücht ~ Gerüchte	Rumor	
Die Schwerkraft ~ Die Gewichte	Gravity	
Die Zuflucht ~ Die Unterstände	Shelter	
Das Abenteuer ~ Die Abenteuer	Adventure	
Der Löwe ~ Die Löwen	Lion	
Die Wirbelsäule ~ Die Stacheln	Spine	
Das Vertrauen ~ Die Vertraulichkeiten	Confidence	
Die Tiefe ~ Die Tiefen	Depth	
Die Reichweite ~ Die Reichweiten	Reach	
Der Hammer ~ Die Hämmer	Hammer	
Die Bibel ~ Die Bibeln	Bible	
Der Vertrag ~ Die Verträge	Contract	
Der Geldbeutel ~ Die Brieftaschen	Wallet	
Der Dschungel ~ Die Dschungel	Jungle	
Die Fabrik ~ Die Fabriken	Factory	
Die Indische ~ Die Indianer	Indian	
Der Balkon ~ Die Balkone	Balcony	
Der Reis ~ Die Reis	Rice	
Der Knoten ~ Die Knoten	Knot	
Die Schnur ~ Die Schnüre	Cord	
Der Kollege ~ Die Kollegen	Colleague	
Die Absicht ~ Die Absichten	Intention	
Die Stare ~ Die Blicke	Stare	
Das Motel ~ Die Motels	Motel	
Der Liebling ~ Die Lieblinge	Darling	
Die Diskussion ~ Die Diskussionen	Discussion	
Atmosphäre ~ Die Atmosphären	Atmosphere	
Die Leistung ~ Die Aufführungen	Performance	
Die Spannung ~ Die Spannungen	Tension	
Der Text ~ Die Texte	Text	
Der Strang ~ Die Litzen	Strand	
Die Mittags ~ Die Noons	Noon	
Die Vene ~ Die Venen	Vein	
Der Experte ~ Die Experten	Expert	
Die Gruppe ~ Die Banden	Gang	
Der Polizist ~ Die Police	Policeman	
Der Krebs ~ Die Krebs	Cancer	
Der Fuchs ~ Die Foxs	Fox	
Die Scheidung ~ Die Scheidungen	Divorce	
Die Impuls ~ Die Pulse	Pulse	
Die Abwesenheit ~ Die Abwesenheiten	Absence	
Die Gewalt ~ Die Gewalten	Violence	
Der Humor ~ Die Körpersäfte	Humor	
Der Kies ~ Die Kiese	Gravel	
Der Schatz ~ Schätze	Treasure	
Die Butter ~ Die Butter	Butter	
Der Schalter ~ Die Schalter	Switch	
Die Zigarre ~ Die Zigarren	Cigar	
Die Leinwand ~ Die Leinwände	Canvas	
Die Fröhlichkeit ~ Die Seligkeiten	Happiness	
Der Führer ~ Die Führungen	Guide	
Der Schauspieler ~ Die Akteure	Actor	
Das Ganze ~ Die Löcher	Whole	
Die Vereinbarung ~ Die Vereinbarungen	Arrangement	
Die Braune ~ Die Brauntöne	Brown	
Der Gastgeber ~ Die Gastgeber	Host	
Das Farbband ~ Die Bänder	Ribbon	
Der Schal ~ Die Schals	Scarf	
Die Skala ~ Die Waagen	Scale	
Der Pfeil ~ Die Pfeile	Arrow	
Die Temperatur ~ Die Temperaturen	Temperature	
Die Technologie ~ Technologien	Technology	
Die Erlaubnis ~ Die Berechtigungen	Permission	
Der Ort ~ Die Standorte	Location	
Die Klaue ~ Die Krallen	Claw	
Der Cowboy ~ Die Cowboies	Cowboy	
Die Agentur ~ Die Agenturen	Agency	
Die Konstruktion ~ Die Konstruktionen	Construction	
Das Jagd ~ Die Jagden	Hunting	
Das Gemüse ~ Das Gemüse	Vegetable	
Der Hubschrauber ~ Die Hubschrauber	Helicopter	
Die Falle ~ Die Fallen	Trap	
Das Pat ~ Die Streicheleinheiten	Pat	
Die Lücke ~ Die Lücken	Gap	
Das Haustier ~ Die Haustiere	Pet	
Die Bildung ~ Die Ausbildungen	Education	
Das Einkaufen ~ Die Einkäufe	Shopping	
Der Schuppen ~ Die Schuppen	Shed	
Die Vereinbarung ~ Vereinbarungen	Agreement	
Die Erde ~ Die Böden	Soil	
Der Herzog ~ Die Herzöge	Duke	
Die Schrotflinte ~ Die Schrotflinten	Shotgun	
Die Vorstellung ~ Die Begriffe	Notion	
Es Gibt ~ Die Hintern	Rear	
Die Zeremonie ~ Die Zeremonien	Ceremony	
Der Löffel ~ Die Löffel	Spoon	
Die Wanne ~ Die Wannen	Tub	
Der Schlüssel ~ Die Hinweise	Clue	
Die Iris ~ Die Iris	Iris	
Der Vorfall ~ Die Vorfälle	Incident	
Der Absturz ~ Die Abstürze	Crash	
Das Tagebuch ~ Die Zeitschriften	Journal	
Die Zugriffs ~ Die Zugriffe	Access	
Erz ~ Die Brasses	Brass	
Die Mama ~ Die Mamas	Mommy	
Die Seitenleiste ~ Die Seitenleisten	Sidebar	
Das Schaf ~ Die Schafe	Sheep	
Der Ingenieur ~ Die Ingenieure	Engineer	
Der Rumpf ~ Die Rümpfe	Hull	
Der Termin ~ Die Termine	Appointment	
Die Einladung ~ Die Einladungen	Invitation	
Die Lappen ~ Die Lumpen	Rag	
Das Gute ~ Die Güter	Good	
Der Kumpel ~ Die Dudes	Dude	
Die Behandlung ~ Behandlungen	Treatment	
Die Weisheit ~ Die Weisheiten	Wisdom	
Das Element ~ Die Elemente	Element	
Der Gigant ~ Die Riesen	Giant	
Die Serviette ~ Die Servietten	Napkin	
Die Wäsche ~ Die Wäschereien	Laundry	
Die Option ~ Die Optionen	Option	
Das Regal ~ Die Zahnstangen	Rack	
Die Anforderung ~ Die Anfragen	Request	
Der Opa ~ Die Großväter	Grandpa	
Die Ranch ~ Die Ranches	Ranch	
Das Skript ~ Die Skripte	Script	
Die Einkaufshalle ~ Die Einkaufszentren	Mall	
Der Ford ~ Die Furten	Ford	
Die Übung ~ Die Übungen	Exercise	
Die Witwe ~ Die Witwen	Widow	
Die Krähe ~ Die Krähen	Crow	
Der Faden ~ Die Fäden	Thread	
Die Selbstmord ~ Die Selbstmorde	Suicide	
Die Notiz ~ Die Bekanntmachungen	Notice	
Der Sonnenuntergang ~ Die Sonne Geht Unter	Sunset	
Die Gallerie ~ Die Galerien	Gallery	
Das Schiff ~ Die Gefäße	Vessel	
Der Donner ~ Der Donner	Thunder	
Die Seife ~ Seifen	Soap	
Der Whisky ~ Die Whiskys	Whiskey	
Das Weibchen ~ Die Weibchen	Female	
Der Bürgermeister ~ Die Bürgermeister	Mayor	
Der Hub ~ Die Striche	Stroke	
Der Klick ~ Die Klicks	Click	
Der Ruf ~ Der Ruf	Reputation	
Der Müller ~ Die Müller	Miller	
Der Rat ~ Die Räte	Council	
Der Stundenplan ~ Der Spielplan	Schedule	
Der Friedhof ~ Die Friedhöfe	Cemetery	
Der Instinkt ~ Die Instinkte	Instinct	
Die Ruhe ~ Die Beruhigt	Calm	
Der Arbeitnehmer ~ Die Angestellten	Employee	
Das Nest ~ Die Nester	Nest	
Das Limit ~ Die Grenzwerte	Limit	
Der Deutsche ~ Die Deutschen	German	
Der Mönch ~ Die Mönche	Monk	
Der Wurm ~ Die Würmer	Worm	
Das Dokument ~ Die Dokumente	Document	
Die Traurigkeit ~ Die Traurigkeiten	Sadness	
Die Hütte ~ Die Hütten	Hut	
Die Lebensdauer ~ Die Lebensdauern	Lifetime	
Die Tänzerin ~ Die Tänzer	Dancer	
Die Versicherung ~ Die Versicherungen	Insurance	
Die Schwierigkeit ~ Die Schwierigkeiten	Difficulty	
Die Matratze ~ Die Matratzen	Mattress	
Der Mann ~ Die Männchen	Male	
Die Klinik ~ Die Kliniken	Clinic	
Die Ad ~ Die Anzeigen	Ad	
Der Becher ~ Die Becher	Mug	
Das Kit ~ Die Kits	Kit	
Die Kommunikation ~ Die Kommunikations	Communication	
Das Unglück ~ Die Katastrophen	Disaster	
Die Fliese ~ Die Fliesen	Tile	
Der Empfänger ~ Die Empfänger	Receiver	
Das Gebrüll ~ Die Brüllt	Roar	
Die Truppe ~ Die Truppen	Troop	
Der Sarg ~ Die Särge	Coffin	
Die Freundschaft ~ Die Freundschaften	Friendship	
Die Ermittlung ~ Die Untersuchungen	Investigation	
Der Verkauf ~ Die Verkäufe	Sale	
Der Krankenwagen ~ Die Krankenwagen	Ambulance	
Das Mondlicht ~ Die Mondlicht	Moonlight	
The Ward ~ Die Schutzzauber	Ward	
Die Hosen ~ Die Trouserses	Trousers	
Die Wolle ~ Die Wolle	Wool	
Die Mac ~ Die Macs	Mac	
Der Minister ~ Die Minister	Minister	
Der Eintritt ~ Die Einträge	Entry	
Der Dieb ~ Die Diebe	Thief	
Die Aktentasche ~ Die Aktentaschen	Briefcase	
Das Mitleid ~ Die Bemitleidet	Pity	
Die Finger ~ Die Fingerspitzen	Fingertip	
Die Marine ~ Die Marinen	Navy	
Das Insekt ~ Die Insekten	Insect	
The Velvet ~ Die Samt	Velvet	
Die Biene ~ Die Bienen	Bee	
Das Gen ~ Die Gene	Gene	
Der Salat ~ Die Salate	Salad	
Die Windschutzscheibe ~ Die Windschutzscheiben	Windshield	
Das Outfit ~ Die Outfits	Outfit	
Der Shuttle ~ Die Shuttles	Shuttle	
Der Schrei ~ Die Rufe	Shout	
Die Wut ~ Die Furien	Fury	
Die Herausforderung ~ Die Herausforderungen	Challenge	
Die Zufriedenheit ~ Die Zufriedenheiten	Satisfaction	
Das Produkt ~ Die Produkte	Product	
Das Unkraut ~ Das Unkraut	Weed	
Die Strecke ~ Die Strecken	Stretch	
Das Fitnesscenter ~ Die FitnessStudios	Gym	
Das Kapital ~ Die Hauptstädte	Capital	
Der Rand ~ Die Felgen	Rim	
Die Pfote ~ Die Pfoten	Paw	
Die Festung ~ Die Forts	Fort	
Die Kosten ~ Die Kosten	Cost	
Das Plakat ~ Die Poster	Poster	
Der Vampir ~ Die Vampire	Vampire	
Die Identität ~ Die Identitäten	Identity	
Das Arschloch ~ Die Arschlöcher	Asshole	
Der Gurt ~ Die Gurte	Strap	
Das Wohnzimmer ~ Die Stuben	Parlor	
Der Hafen ~ Die Häfen	Harbor	
Das Beispiel ~ Beispiele	Example	
Das Netz ~ Die Stege	Web	
Der Golf ~ Die Golfplätze	Golf	
Den Mist ~ Scheißt	Crap	
Die Decke ~ Diese Decken	Quilt	
Die Steuer ~ Die Taxs	Tax	
Die Falte ~ Die Falten	Fold	
Das Porträt ~ Die Porträts	Portrait	
Das Gewebe ~ Die Gewebe	Tissue	
Der Glaube ~ Die Überzeugungen	Belief	
Das Kostüm ~ Die Kostüme	Costume	
Das Maß ~ Maßnahmen	Measure	
Die Gitarre ~ Die Gitarren	Guitar	
Der Ritter ~ Die Ritter	Knight	
Der Rang ~ Die Reihen	Rank	
Der Bürgermeister ~ Die Majors	Major	
Der Brunnen ~ Die Brunnen	Fountain	
Der Stall ~ Die Stände	Stall	
Die Ladung ~ Die Lasten	Load	
Der Funke ~ Die Funken	Spark	
Der Müll ~ Die Abfälle	Waste	
Der Champagner ~ Die Champagner	Champagne	
Das Viertel ~ Die Bezirke	District	
Der Schutz ~ Die Schutz	Protection	
Das Urteil ~ Die Urteile	Judgment	
Die Sympathie ~ Die Sympathien	Sympathy	
Das Violett ~ Die Veilchen	Violet	
Der Aufprall ~ Die Auswirkungen	Impact	
Die Enttäuschung ~ Die Enttäuschungen	Disappointment	
Das Trink ~ Die Drinkings	Drinking	
Das Bewusstsein ~ Die Bewussts	Consciousness	
Das Taschentuch ~ Die Taschentücher	Handkerchief	
Das Tanzen ~ Die Dancings	Dancing	
Das Parfüm ~ Die Düfte	Perfume	
Das Netzwerk ~ Die Netzwerke	Network	
Der Anspruch ~ Die Ansprüche	Claim	
Die Nonne ~ Die Nonnen	Nun	
Die Krone ~ Die Kronen	Crown	
Das Geländer ~ Die Geländer	Railing	
Die Lizenz ~ Die Lizenzen	License	
Die Barmherzigkeit ~ Die Barmherzigkeit	Mercy	
Der Ballon ~ Die Ballons	Balloon	
Das Chaos ~ Die Chaoses	Chaos	
Das Fieber ~ Die Fieber	Fever	
Das Schließfach ~ Die Schließfächer	Locker	
Die Sitzung ~ Die Sitzungen	Session	
Die Burst ~ Die Bursts	Burst	
Der Spitzer ~ Die Peaks	Peak	
Die Trommel ~ Die Trommeln	Drum	
Der Fokus ~ Die Schwerpunkte	Focus	
Der Frosch ~ Die Frösche	Frog	
Die Bemerkung ~ Die Bemerkungen	Remark	
Die Gezeiten ~ Die Gezeiten	Tide	
Der Verdacht ~ Der Verdacht	Suspicion	
Der Jeep ~ Die Jeeps	Jeep	
Die Sorge ~ Die Sorgen	Worry	
Die Literatur ~ Die Literaturen	Literature	
Der Bogenschütze ~ Die Bogenschützen	Archer	
Der Haushalt ~ Die Haushalte	Household	
Das Pulver ~ Die Pulver	Powder	
Der Hirte ~ Die Hirten	Shepherd	
Die Linse ~ Die Linsen	Lens	
Der Favorit ~ Die Favoriten	Favorite	
Die Madame ~ Die Madames	Madame	
Die Villa ~ Die Herrenhäuser	Mansion	
Der Boom ~ Die Ausleger	Boom	
Die Spitze ~ Die Schnürsenkel	Lace	
Die Überprüfung ~ Die Bewertungen	Review	
Die Rezeption ~ Die Empfänge	Reception	
Der Schrott ~ Die Fetzen	Scrap	
Der Wulst ~ Die Perlen	Bead	
Die Blendung ~ Die Blicke	Glare	
Die Strömung ~ Die Ströme	Flow	
Das Cafe ~ Die Cafés	Cafe	
Der Status ~ Die Zustände	Status	
Das Pochen ~ Die Poundings	Pounding	
Die Rakete ~ Die Raketen	Rocket	
Die Schlucht ~ Die Schluchten	Canyon	
Die Trauer ~ Die Leiden	Sorrow	
Die Spinne ~ Die Spinnen	Spider	
Die Explosion ~ Die Blasten	Blast	
Die Persönlichkeit ~ Die Persönlichkeiten	Personality	
Der Campus ~ Die Campus	Campus	
Der Fluch ~ Die Flüche	Curse	
Das Treppenhaus ~ Die Treppenhäuser	Staircase	
Der Drang ~ Die Triebe	Urge	
Die Frustration ~ Die Frustrationen	Frustration	
Die Pumpe ~ Die Pumpen	Pump	
Die Leichtigkeit ~ Die Kungen	Ease	
Die Zählung ~ Die Grafen	Count	
Die Lösung ~ Die Lösungen	Solution	
Der Schmuck ~ Die Schmuck	Jewelry	
Die Sirene ~ Die Sirenen	Siren	
Der Schlag ~ Die Treffer	Hit	
Die Tradition ~ Die Traditionen	Tradition	
Das Leer ~ Die Bordsteine	Curb	
Die Vielfalt ~ Die Sorten	Variety	
Der Pirat ~ Die Piraten	Pirate	
Die Beschreibung ~ Beschreibungen	Description	
Der Liebe ~ Die Lieben	Dear	
Die Tonhöhe ~ Die Stellplätze	Pitch	
Die Pizza ~ Die Pizzas	Pizza	
Der Elefant ~ Die Elefanten	Elephant	
Die Politik ~ Die Politicses	Politics	
Der Tennis ~ Die Tennises	Tennis	
Der Hunger ~ Die Hungert	Hunger	
Das Genie ~ Die Genies	Genius	
Die Ziege ~ Die Ziegen	Goat	
Der Sieg ~ Die Siege	Victory	
Die Kombination ~ Kombinationen	Combination	
Die Zugehörigkeit ~ Die Zugehörigkeiten	Affiliation	
Das Momma ~ Die Mommas	Momma	
Der Umhang ~ Die Umhänge	Cape	
Der Scheinwerfer ~ Die Scheinwerfer	Headlight	
Der Gouverneur ~ Die Gouverneure	Governor	
Die Sauerstoff ~ Sauerstoffe	Oxygen	
Der Bischof ~ Die Bischöfe	Bishop	
Das Bündel ~ Die Bündel	Bundle	
Die Entwicklung ~ Die Entwicklungen	Development	
Der Fingernagel ~ Die Fingernägel	Fingernail	
Die Punktzahl ~ Die Noten	Score	
Der Steuermann ~ Die Mates	Mate	
Die Umlaufbahn ~ Die Bahnen	Orbit	
Der Weinstock ~ Die Reben	Vine	
Die Suite ~ Die Suiten	Suite	
Der Barkeeper ~ Die Barkeeper	Bartender	
Der Koks ~ Die Kokse	Coke	
Die Melodie ~ Die Melodien	Tune	
Die Herrlichkeit ~ Die Herrlichkeiten	Glory	
Der Rabbi ~ Die Rabbiner	Rabbi	
Das Vieh ~ Die Rinder	Cattle	
Das Ritual ~ Die Rituale	Ritual	
Die Begrüßung ~ Die Grüße	Greeting	
Die Scheibe ~ Die Scheiben	Slice	
Die Homer ~ Die Home Runs	Homer	
Der Kamin ~ Die Kamine	Fireplace	
Das Trikot ~ Die Trikots	Jersey	
Die Medien ~ Die Medien	Media	
Die Pop ~ The Pops	Pop	
Die Fracht ~ Die Ladungen	Cargo	
Das Gasthaus ~ Die Gasthöfe	Inn	
Der Stellvertretende ~ Die Abgeordneten	Deputy	
Die Verzweiflung ~ Die Verzweiflungen	Despair	
Das Territorium ~ Die Gebiete	Territory	
Der Schlag ~ Die Stempel	Punch	
Die Jazz ~ Die Jazzs	Jazz	
Die Umarmung ~ Die Umarmungen	Hug	
Die Pfeife ~ Die Pfeifen	Whistle	
Die Menschlichkeit ~ Geisteswissenschaften	Humanity	
Das Handwerk ~ Das Handwerk	Craft	
Das Tageslicht ~ Die Daylighies	Daylight	
Der Wert ~ Die Inneren Werte	Worth	
Der Slip ~ Die Schieber	Slip	
Die Rüstung ~ Die Rüstungen	Armor	
Der Rucksack ~ Die Rucksäcke	Backpack	
Der Vorschlag ~ Die Vorschläge	Suggestion	
Die Höhle ~ Dens	Den	
Das Symbol ~ Die Symbole	Symbol	
Die Kolonie ~ Die Kolonien	Colony	
Das Fazit ~ Die Schlussfolgerungen	Conclusion	
Das Nasenloch ~ Die Nasenlöcher	Nostril	
Der Speer ~ Die Speere	Spear	
Der Impuls ~ Die Impulse	Impulse	
Die Tomate ~ Die Tomaten	Tomato	
Das Kalb ~ Die Kälber	Calf	
Der Herbst ~ Die Herbste	Autumn	
Der Fund ~ Die Entdeckungen	Discovery	
Das Klassenzimmer ~ Die Klassenzimmer	Classroom	
Die Lieferung ~ Die Einteilungen	Delivery	
Das Spray ~ Die Spraies	Spray	
Die Flüssigkeit ~ Die Flüssigkeiten	Liquid	
Die Kraftstoff ~ Die Kraftstoffe	Fuel	
Die Unterwäsche ~ Die Unterwäsche	Underwear	
Die Kuppel ~ Die Kuppeln	Dome	
Die Bevölkerung ~ Die Populationen	Population	
Die Neigung ~ Die Neigungen	Affection	
Die Religion ~ Die Religionen	Religion	
Der Sänger ~ Die Sänger	Singer	
Der Begleiter ~ Die Teilnehmer	Attendant	
Die Illusion ~ Die Illusionen	Illusion	
Der Link ~ Links	Link	
Das Wohnzimmer ~ Die Lounges	Lounge	
Der Innenraum ~ Die Innenräume	Interior	
Die Achselzucken ~ Die Zuckt Mit Den Schultern	Shrug	
Die Zone ~ Die Zonen	Zone	
Der Standard ~ Die Standards	Standard	
Die Kohlen ~ Die Kohlen	Coal	
Die Jagd ~ Die Verfolgungsjagden	Chase	
Der Klumpen ~ Die Klumpen	Lump	
Der Charm ~ Der Charme	Charm	
Die Legende ~ Die Legenden	Legend	
Die Konsequenz ~ Die Konsequenzen	Consequence	
Die Beobachtung ~ Die Beobachtungen	Observation	
Die Zahlung ~ Das Zahlt	Pay	
Das Prospekt ~ Die Aussichten	Prospect	
Die UBahn ~ Die UBahnen	Subway	
Das Muster ~ Die Beispiele	Sample	
Die Kirsche ~ Die Kirschen	Cherry	
Der Händler ~ Die Händler	Dealer	
Die Zuordnung ~ Die Zuordnungen	Assignment	
Die Eile ~ Die Eilt	Hurry	
Die Geliebte ~ Die Mätressen	Mistress	
Der Unsinn ~ Die Unsinn	Nonsense	
Das Komitee ~ Die Ausschüsse	Committee	
Das Echo ~ Die Echos	Echo	
Der Durchhang ~ Die Hose	Slack	
Die Decker ~ Die Decker	Decker	
Das Warenhaus ~ Die Lagerhäuser	Warehouse	
Der Toast ~ Die Toasts	Toast	
Die Einrichtung ~ Die Einrichtungen	Facility	
Der Basketball ~ Die Basketbälle	Basketball	
Der Schnurrbart ~ Die Schnurrbärte	Mustache	
Der Senator ~ Die Senatoren	Senator	
Das Teilen ~ Die Aktien	Share	
Das Augenlid ~ Die Augenlider	Eyelid	
Die Begeisterung ~ Die Begeisterung	Enthusiasm	
Die Chunk ~ Die Brocken	Chunk	
Die Schildkröte ~ Die Schildkröten	Turtle	
Der Alkohol ~ Die Alkohole	Alcohol	
Die Gummi ~ Die Gummis	Gum	
Der Truthahn ~ Die Truthähne	Turkey	
Der Prediger ~ Die Prediger	Preacher	
Der Besitz ~ Die Besitzungen	Possession	
Der Dolly ~ Die Dollies	Dolly	
Das Leinen ~ Die Bettwäsche	Linen	
Die Entschuldigung ~ Die Entschuldigung	Apology	
Der Vortrag ~ Die Vorträge	Lecture	
Der Stein ~ Die Felsbrocken	Boulder	
Der Heap ~ Die Haufen	Heap	
Der Fotograf ~ Die Fotografen	Photographer	
Die Bremse ~ Die Bremsen	Brake	
Die Nachfrage ~ Die Forderungen	Demand	
Die Schürze ~ Die Schürzen	Apron	
Der Mantel ~ Die Umhänge	Cloak	
Die Jury ~ Jurys	Jury	
Die Anhörung ~ Die Anhörungen	Hearing	
Das Graue ~ Die Grautöne	Gray	
Die Kiste ~ Die Kisten	Crate	
Die Methode ~ Methoden	Method	
Die Referenz ~ Die Verweise	Reference	
Der Ekel ~ Die Ekelt	Disgust	
Die Flotte ~ Die Flotten	Liquor	
Der Lippenstift ~ Lippenstifte	Lipstick	
Der Kern ~ Die Kerne	Core	
Der Einzelne ~ Die Personen	Individual	
Der Container ~ Die Behälter	Container	
Die Hure ~ Die Huren	Whore	
Das Kleinkind ~ Die Säuglinge	Infant	
Die Sonnenbrille ~ Die Sunglasseses	Sunglasses	
Der Schlauch ~ Die Schläuche	Hose	
Das Konzert ~ Konzerte	Concert	
Das Bullshit ~ Die Bullshits	Bullshit	
Die Eisenbahn ~ Die Eisenbahnen	Railroad	
Die Parade ~ Die Paraden	Parade	
Das Fach ~ Die Abteile	Compartment	
Der Bewohner ~ Die Bewohner	Resident	
Der Backofen ~ Die Öfen	Oven	
Der Techniker ~ Die Techniker	Technician	
Das Verfahren ~ Die Verfahren	Procedure	
Der Kämpfer ~ Die Kämpfer	Fighter	
Das Korn ~ Die Körner	Grain	
Das Picknick ~ Die Picknicks	Picnic	
Der Stamm ~ Die Stämme	Tribe	
Die Knospe ~ Die Knospen	Bud	
Die Wiese ~ Die Wiesen	Meadow	
Die Öffentlichkeit ~ Die Öffentlichkeit	Public	
Das Gift ~ Die Gifte	Poison	
Der Büffel ~ Die Büffel	Buffalo	
Die Region ~ Die Regionen	Region	
Die Produktion ~ Die Produktionen	Production	
Das Rennen ~ Die Vorlauf	Running	
Die Schleife ~ Die Schlaufen	Loop	
Der Schlaf ~ Die Übernachtungsplätzen	Sleeping	
Die Soda ~ Die Limonaden	Soda	
Die Eule ~ Die Eulen	Owl	
Das Menü ~ Die Menüs	Menu	
Der Kick ~ Die Tritte	Kick	
Die Ruine ~ Die Ruinen	Ruin	
Die Rampe ~ Die Rampen	Ramp	
Unterarm ~ Die Unterarme	Forearm	
Der Achsschenkel ~ Die Knöchel	Knuckle	
Die Gans ~ Die Gänse	Goose	
Der Vormarsch ~ Die Fortschritte	Advance	
Die Fee ~ Die Feen	Fairy	
Die Mannschaft ~ Die Kader	Squad	
Das Offizielle ~ Die Beamten	Official	
Die Marke ~ Die Marken	Brand	
Die Orgel ~ Die Organe	Organ	
Der Schmetterling ~ Die Schmetterlinge	Butterfly	
Das Reich ~ Die Reiche	Empire	
Das Profil ~ Die Profile	Profile	
Die Freiheit ~ Freiheiten	Liberty	
Der Unglaube ~ Die Unglauben	Disbelief	
Der Hain ~ Die Haine	Grove	
Das Schild ~ Die Abschirmungen	Shield	
Der Sattel ~ Die Sättel	Saddle	
Die Chancen ~ Die Oddses	Odds	
Die Cluster ~ Die Cluster	Cluster	
Der Satellit ~ Die Satelliten	Satellite	
Der Abzug ~ Die Auslöser	Trigger	
Der Welpe ~ Die Welpen	Puppy	
Die Warte ~ Die Erwartungen	Waiting	
Die Glühbirne ~ Die Zwiebeln	Bulb	
Die Kommode ~ Die Kommoden	Dresser	
Die Patrouille ~ Die Patrouillen	Patrol	
Der Adler ~ Die Adler	Eagle	
Der Privatsphäre ~ Die Privatsphären	Privacy	
Das Fluid ~ Fluide	Fluid	
Die Herde ~ Die Herden	Herd	
Der Kopfschmerz ~ Die Kopfschmerzen	Headache	
Der Vergnügungspark ~ Vergnügungen	Amusement	
Der Rollstuhl ~ Die Rollstühle	Wheelchair	
Die Richtlinie ~ Die Politik	Policy	
Das Belle ~ Die Belles	Belle	
Die Tabak ~ Die Tabake	Tobacco	
Die Einstellung ~ Einstellungen	Setting	
Die Tätowierung ~ Die Tattoos	Tattoo	
Die Last ~ Die Lasten	Burden	
Der Händler ~ Die Kaufleute	Merchant	
Die Rutsche ~ Die Schieber	Slide	
Der Fleck ~ Die Flecken	Stain	
Das Essen ~ Die Eatings	Eating	
Die Bindung ~ Die Anleihen	Bond	
Das Schwimmen ~ Die Swimming	Swimming	
Die Grundlage ~ Die Grundlagen	Foundation	
Die Verletzung ~ Die Verletzungen Haben	Injury	
Die Liga ~ Die Ligen	League	
Die Batterie ~ Die Batterien	Battery	
Der Regenschirm ~ Die Sonnenschirme	Umbrella	
Der Kaiser ~ Die Kaiser	Emperor	
Der Pier ~ Die Pfeiler	Pier	
Der Wasserhahn ~ Die Wasserhähne	Tap	
Der Witz ~ Die Verstand	Wit	
Der Cutter ~ Die Schneidwerkzeuge	Cutter	
Der Dachboden ~ Die Dachböden	Attic	
Der Tiger ~ Die Tiger	Tiger	
Die Pal ~ Die Kumpels	Pal	
Der Vorfahr ~ Die Vorfahren	Ancestor	
Die Konzentration ~ Die Konzentrationen	Concentration	
Der Berg ~ Die Halterungen	Mount	
Der Aufwand ~ Die Kosten	Expense	
Der Segen ~ Die Segnungen	Blessing	
Der Urlaub ~ Das Laub	Leave	
Die Leiste ~ Die Leisten	Ledge	
Die Fackel ~ Die Fackeln	Torch	
Die Tinten ~ Die Tinten	Ink	
Die Handlung ~ Die Grundstücke	Plot	
Die Miete ~ Die Mieten	Rent	
Das Maultier ~ Die Maultiere	Mule	
Die Umgebung ~ Die Umgebungen	Environment	
Das Stirnrunzeln ~ Die Stirn Runzelt	Frown	
Der Inspektor ~ Die Inspektoren	Inspector	
Die Mitten ~ Die Midsts	Midst	
Die Verlegenheit ~ Die Peinlichkeiten	Embarrassment	
Die Beschwerde ~ Die Beschwerden	Complaint	
Die Portion ~ Die Portionen	Portion	
Das Spannfutter ~ Die Spann	Chuck	
Die Clearing ~ Die Lichtungen	Clearing	
Die Krise ~ Die Krisen	Crisis	
Die Halskette ~ Die Halsketten	Necklace	
Die Laterne ~ Die Laternen	Lantern	
Der Reichtum ~ Die Reichtümer	Wealth	
Die Zivilisation ~ Die Zivilisationen	Civilization	
Das Konzept ~ Die Konzepte	Concept	
Das Lamm ~ Die Lämmer	Lamb	
Die Schritt ~ Die Fortschritte	Stride	
Die Manschette ~ Die Manschetten	Cuff	
Die Jungfrau ~ Die Jungfrauen	Virgin	
Das Eichhörnchen ~ Die Eichhörnchen	Squirrel	
Das Kind ~ Die Babes	Babe	
Der Star ~ Die Stare	Starling	
Die Depression ~ Die Vertiefungen	Depression	
Das Speicher ~ Die Speicher	Storage	
Der Altar ~ Die Altäre	Altar	
Die Tragödie ~ Die Tragödien	Tragedy	
Die Ressource ~ Die Mittel	Resource	
Der Reisende ~ Die Reisenden	Traveler	
Das Vertrauen ~ Die Trusts	Trust	
Die Bogen ~ Die Bögen	Arc	
Das Königreich ~ Die Königreiche	Kingdom	
Das Juwel ~ Die Juwelen	Jewel	
Der Musiker ~ Die Musiker	Musician	
Die Junk ~ Die Dschunken	Junk	
Der Sonnenschein ~ Die Sonne Scheint	Sunshine	
Der Knabe ~ Die Jungs	Lad	
Der Elf ~ Die Elfen	Elf	
Der Protest ~ Die Proteste	Protest	
Die Jagd ~ Die Jagden	Hunt	
Die Exekutive ~ Die Führungskräfte	Executive	
Das Tagebuch ~ Die Tagebücher	Diary	
Das Aspekt ~ Die Aspekte	Aspect	
Das Zifferblatt ~ Die Zifferblätter	Dial	
Der Hausschuh ~ Die Pantoffeln	Slipper	
Die Schauspielerin ~ Die Schauspielerinnen	Actress	
Das Shooting ~ Die Dreharbeiten	Shooting	
Der Ohrring ~ Die Ohrringe	Earring	
Die Ameise ~ Die Ameisen	Ant	
Die Patty ~ Die Bratlinge	Patty	
Die Sauce ~ Die Soßen	Sauce	
Die Intensität ~ Die Intensitäten	Intensity	
Der Graben ~ Die Gräben	Ditch	
Das Gänseblümchen ~ Das Gänseblümchen	Daisy	
Die Kapelle ~ Die Kapellen	Chapel	
Der Sumpf ~ Die Sümpfe	Swamp	
Die Beziehung ~ Die Beziehungen	Relation	
Die Vermutung ~ Die Vermutungen	Guess	
Der Kran ~ Die Kräne	Crane	
Die Begegnung ~ Die Begegnungen	Encounter	
Die Sequenz ~ Die Sequenzen	Sequence	
Das Fragment ~ Die Fragmente	Fragment	
Der Entwurf ~ Die Entwürfe	Draft	
Das Diner ~ Diners	Diner	
Die Funktion ~ Die Funktionen	Function	
Die Organisation ~ Die Organisationen	Organization	
Das Skelett ~ Die Skelette	Skeleton	
Das Elend ~ Das Elend	Misery	
Das Kraut ~ Die Kräuter	Herb	
Der Stumpf ~ Die Stümpfe	Stump	
Der Einsatz ~ Die Einsätze	Stake	
Die Puff ~ Die Windbeutel	Puff	
Die Kreation ~ Die Kreationen	Creation	
Das Gefolge ~ Die Totenwache	Wake	
Der Zauberer ~ Die Zauberer	Wizard	
Die Matte ~ Die Matten	Mat	
Die Dichtung ~ Die Dichtungen	Seal	
Das Zwielicht ~ Die Dämmerungen	Twilight	
Das Grunzen ~ Das Grunzen	Grunt	
Die Strafe ~ Die Strafen	Punishment	
Der Clan ~ Die Clans	Clan	
Das Kupfer ~ Die Kupfer	Copper	
Die Trümmer ~ Die Debrises	Debris	
Der Maler ~ Die Maler	Painter	
Das Steuer ~ Die Lenkungen	Steering	
Die Mathematik ~ Die Mathematik	Math	
Die Erkennung ~ Die Anerkennungen	Recognition	
Die Stimmung ~ Die Gemüter	Temper	
Das Bedauern ~ Die Reue	Regret	
Die Mühle ~ Die Mühlen	Mill	
Die Romantik ~ Die Romane	Romance	
Das Thema ~ Die Themen	Topic	
Die Terrasse ~ Die Innenhöfe	Patio	
Die Schaufel ~ Schaufeln	Shovel	
Die Schlafanzüge ~ Die Pajamases	Pajamas	
Die Email ~ Die EMails	EMail	
Die Taube ~ Die Tauben	Pigeon	
Der Dinosaurier ~ Die Dinosaurier	Dinosaur	
Die Branche ~ Die Industrie	Industry	
Der Betreiber ~ Die Betreiber	Operator	
Der Lift ~ Die Lifte	Lift	
Der Ratgeber ~ Die Berater	Counselor	
Die Versammlung ~ Die Versammlungen	Gathering	
Das Prinzip ~ Die Grundsätze	Principle	
Das Drama ~ Die Dramen	Drama	
Das Küken ~ Die Küken	Chick	
Das Diagramm ~ Die Charts	Chart	
Die Kampagne ~ Die Kampagnen	Campaign	
Der Lorbeer ~ Die Lorbeeren	Laurel	
Das Steak ~ Die Steaks	Steak	
Der Kriminelle ~ Die Verbrecher	Criminal	
Der Globus ~ Die Kugeln	Globe	
Der Bluterguss ~ Die Blauen Flecken	Bruise	
Der Knopf ~ Die Noppen	Knob	
Das Töten ~ Die Morde	Killing	
Der Schatz ~ Die Lieblinge	Sweetheart	
Die Oper ~ Die Opern	Opera	
Der Frost ~ Die Fröste	Frost	
Der Nippel ~ Die Brustwarzen	Nipple	
Der Pfarrer ~ Die Pastoren	Reverend	
Die Trübung ~ Die Trübungen	Haze	
Das Hochwasser ~ Die Fluten	Flood	
Das Weihnachtslied ~ Die Weihnachtslieder	Carol	
Die Schwäche ~ Schwächen	Weakness	
Das Kochen ~ Die Cookings	Cooking	
Der Metzger ~ Die Metzger	Butcher	
Der Würfel ~ Die Würfel	Cube	
Der Hohl ~ Die Hohlräume	Hollow	
Der Höcker ~ Die Höcker	Bump	
Der Halt ~ Die Haltepunkte	Halt	
Das Heu ~ Hays	Hay	
Die Rinde ~ Die Rinden	Bark	
Die Überlebens ~ Die Überreste	Survival	
Die Etagen ~ Die Kojen	Bunk	
Die Biegung ~ Die Biegungen	Bend	
Die Freigabe ~ Die Zulassungen	Approval	
Der Unternehmensbereich ~ Die Abteilungen	Division	
Der Cocktail ~ Die Cocktails	Cocktail	
Der Wettbewerb ~ Die Neuesten Informationen	Contest	
Das Paradies ~ Die Paradiese	Paradise	
Das Rasiermesser ~ Die Rasierer	Razor	
Der Fang ~ Die Fänge	Catch	
Die Blüte ~ Die Blüten	Blossom	
Die Pfütze ~ Die Pfützen	Puddle	
Der Strom ~ Die Elektricitäten	Electricity	
Die Zwiebel ~ Die Zwiebeln	Onion	
Die Laser ~ Die Laser	Laser	
Der Einfluss ~ Die Einflüsse	Influence	
Der Sprung ~ Die Sprünge	Jump	
Der Zement ~ Die Zemente	Cement	
Die Gelbe ~ The Ambers	Amber	
Die Göttin ~ Die Göttinnen	Goddess	
The Shack ~ Die Baracken	Shack	
Die Verkäufe ~ Die Saleses	Sales	
Die Drift ~ Die Drifts	Drift	
Die Kämpfe ~ Die Kämpfe	Fighting	
Das Geflecht ~ Die Zöpfe	Braid	
Die Würde ~ Die Dignität	Dignity	
Die Zitrone ~ Die Zitronen	Lemon	
Der Clown ~ Die Clowns	Clown	
Die Brille ~ Die Schutzbrillen	Goggle	
Die Zerstörung ~ Die Zerstörungen	Destruction	
Die Ausnahme ~ Die Ausnahmen	Exception	
Der Pfirsich ~ Die Pfirsiche	Peach	
Die Wasch ~ Die Wasch	Wash	
Die Befreiung ~ Die Freigaben	Release	
Der Spion ~ Die Spione	Spy	
Die Tag ~ Die Tags	Tag	
Der Bh ~ Die Bhs	Bra	
Die Schuld ~ Die Schulden	Debt	
Die Terrasse ~ Die Terrassen	Terrace	
Die Überbleibsel ~ Die Remainses	Remains	
Die Logik ~ Die Logik	Logic	
Der Joint ~ Die Gelenke	Joint	
Der Krug ~ Die Krüge	Pitcher	
Die Perspektive ~ Die Perspektiven	Perspective	
Die Ernte ~ Die Ernte	Crop	
Der Diplom ~ Die Absolventen	Graduate	
Der Chor ~ Die Chöre	Chorus	
Der Überlebende ~ Die Überlebenden	Survivor	
Die Bezahlung ~ Zahlungen	Payment	
Die Wette ~ Die Wetten	Bet	
Die Rache ~ Die Rache	Revenge	
Der Platz ~ Die Plätze	Plaza	
Der Ältere ~ Die Ältesten	Elder	
Der Ingwer ~ Die Ingwer	Ginger	
Der Chirurg ~ Die Chirurgen	Surgeon	
Der Bindestrich ~ Die Striche	Dash	
Die Sandale ~ Die Sandalen	Sandal	
Der Hass ~ Die Hass	Hatred	
Die Abfahrt ~ Die Abfahrten	Departure	
Der Umriss ~ Die Umrisse	Outline	
Der Rabe ~ Die Raben	Raven	
Der Läufer ~ Die Läufer	Runner	
Die Vorfreude ~ Die Erwartungen	Anticipation	
Die Übersetzung ~ Die Übersetzungen	Translation	
Das Hauptquartier ~ Die Headquarterses	Headquarters	
Feier ~ Die Feiern	Celebration	
Die Qual ~ Die Qualen	Agony	
Die Turnschuhe ~ Die Sneakerses	Sneakers	
Das Terminal ~ Die Endgeräte	Terminal	
Die Erwartung ~ Die Erwartungen	Expectation	
Die Weide ~ Die Weiden	Pasture	
Die Konsole ~ Die Konsolen	Console	
Der Streik ~ Die Streiks	Strike	
Die Rettung ~ Die Rettungsaktionen	Rescue	
Das Abzeichen ~ Badges	Badge	
Der Fonds ~ Die Mittel	Fund	
Das Foyer ~ Die Foyeies	Foyer	
Der Pastor ~ Die Pastoren	Pastor	
Das Puzzle ~ Die Rätsel	Puzzle	
Die Wohlfahrt ~ Die Wohltätigkeitsorganisationen	Charity	
Der Direktor ~ Die Auftraggeber	Principal	
Der Applaus ~ Die Beifall	Applause	
Die Philosophie ~ Die Philosophien	Philosophy	
Die Bis ~ Die Höhen	Up	
Der Neffe ~ Die Neffen	Nephew	
Der Aufsatz ~ Die Aufsätze	Essay	
Die Reparatur ~ Die Reparaturen	Repair	
Der Mix ~ Die Mixs	Mix	
Der Mob ~ Die Mobs	Mob	
Die Barriere ~ Die Barrieren	Barrier	
Die Platte ~ Die Scheiben	Disk	
Die Güte ~ Die Goodnesses	Goodness	
Der Scout ~ Die Pfadfinder	Scout	
Die Wichtigkeit ~ Die Wichtigkeiten	Importance	
Die Beihilfen ~ Die Beihilfen	Aid	
Das Mikrofon ~ Die Mikrofone	Microphone	
Das Etikett ~ Die Etiketten	Label	
Der Pfeffer ~ Die Paprika	Pepper	
Der Kojote ~ Die Kojoten	Coyote	
Das Lehren ~ Die Lehren	Teaching	
Der Brennvorgang ~ Die Verbrennungen	Burn	
Die Weste ~ Die Westen	Vest	
Das Pony ~ Die Ponys	Pony	
Der Kreislauf ~ Die Zyklen	Cycle	
Das Keuchen ~ Die Keuchen	Gasp	
Die Ironie ~ Die Ironien	Irony	
Die Auszeichnung ~ Die Auszeichnungen	Award	
Die Traube ~ Die Trauben	Grape	
Das Zögern ~ Die Bedenken	Hesitation	
Die Taverne ~ Die Tavernen	Tavern	
Die Lästige Pflicht ~ Die Hausarbeiten	Chore	
Das Segel ~ Die Segel	Sail	
Die Silhouette ~ Die Silhouetten	Silhouette	
Das Institut ~ Die Institute	Institute	
Der Lügner ~ Die Lügner	Liar	
Die Technik ~ Die Techniken	Technique	
Der Index ~ Die Indexs	Index	
Das Brett ~ Die Bretter	Plank	
Der Ruck ~ Die Idioten	Jerk	
Das Wachstum ~ Die Wucherungen	Growth	
Der Strumpf ~ Die Strümpfe	Stocking	
Die Schwärze ~ Die Schwärzen	Blackness	
Der Teenager ~ Die Jugendlichen	Teen	
Das Armband ~ Die Armbänder	Bracelet	
Gelee ~ Die Gelees	Jelly	
Die Diät ~ Die Diäten	Diet	
Das Fleisch ~ Die Beefs	Beef	
Der Beton ~ Die Betone	Concrete	
Der Kontrast ~ Die Gegensätze	Contrast	
Das Banner ~ Die Banner	Banner	
Der Widerstand ~ Die Widerstände	Resistance	
Der Aufenthalt ~ Die Aufenthalte	Stay	
Die Haltung ~ Die Haltungen	Posture	
Der Wodka ~ Die Wodkas	Vodka	
Das Album ~ Die Alben	Album	
Die Ära ~ Die Epochen	Era	
Die Bekanntschaft ~ Die Bekannten	Acquaintance	
Die Revolution ~ Die Revolutionen	Revolution	
Der Nap ~ Die Noppen	Nap	
Der Schleier ~ Die Schleier	Veil	
Das Schauspiel ~ Die Brille	Spectacle	
Der Wettbewerb ~ Die Wettbewerbe	Competition	
Die Kopfhaut ~ Die Kopfhaut	Scalp	
Die Stechpalme ~ The Hollies	Holly	
Der Gewinner ~ Die Gewinner	Winner	
Der Appetit ~ Die Appetit	Appetite	
Der Efeu ~ Die Efeu	Ivy	
Der Cue ~ Die Stichworte	Cue	
Die Nichte ~ Die Nichten	Niece	
Die Galaxie ~ Die Galaxien	Galaxy	
Die Nacht ~ Die Bettseiten	Bedside	
Die Verrücktheit ~ Die Verrücktheiten	Madness	
Der Bäcker ~ Die Bäcker	Baker	
Das Virus ~ Die Viren	Virus	
Das Leiden ~ Die Leiden	Suffering	
Der Schlitz ~ Die Schlitze	Slot	
Der Ordner ~ Die Hefte	Folder	
Das Bekenntnis ~ Die Geständnisse	Confession	
Der Gepäckträger ~ Die Torhüter	Porter	
Das Dessert ~ Die Desserts	Dessert	
Die Müllhalde ~ Die Deponien	Dump	
Der Gewinn ~ Die Gewinne	Profit	
Der Enkel ~ Die Enkelkinder	Grandchild	
Der Tratsch ~ Der Klatsch	Gossip	
Die Stute ~ Die Stuten	Mare	
Die Dna ~ Die Dnas	Dna	
Der Rumpf ~ Die Torsi	Torso	
Der Besen ~ Die Besen	Broom	
Der Huf ~ Die Hufe	Hoof	
Der Sensor ~ Die Sensoren	Sensor	
Der Gelehrte ~ Die Gelehrten	Scholar	
Die Therapie ~ Die Therapie	Therapy	
Die Erdnuss ~ Die Erdnüsse	Peanut	
Die Schlagzeile ~ Schlagzeilen	Headline	
Der Speck ~ Die Speck	Bacon	
Das Heck ~ Die Hecks	Stern	
Die Geige ~ Die Violinen	Violin	
Die Pest ~ Die Plagen	Plague	
Die Unschärfe ~ Die Unschärfen	Blur	
Die Zwischenzeit ~ Die Zwischenzeiten	Meantime	
Der Diakon ~ Die Diakone	Deacon	
Die Lanze ~ Die Lanzen	Lance	
Die Festnahme ~ Die Verhaftungen	Arrest	
Die Banane ~ Die Bananen	Banana	
Der Gin ~ Die Gins	Gin	
Der Hai ~ Die Haie	Shark	
Die Vorbereitung ~ Die Vorbereitungen	Preparation	
Die Kratz ~ Die Kratzer	Scratch	
Der Verband ~ Die Verbände	Dressing	
Die Unterschrift ~ Unterschriften	Signature	
Der Admiral ~ Die Admirale	Admiral	
Die Analyse ~ Die Analysisies	Analysis	
Der Regenbogen ~ Die Regenbogen	Rainbow	
Die Eidechse ~ Die Eidechsen	Lizard	
Der Zwerg ~ Die Zwerge	Dwarf	
Der Stress ~ Die Belastungen	Stress	
Die Hausaufgabe ~ Die Hausaufgaben	Homework	
Die Mischung ~ Die Mischungen	Mixture	
Der Vers ~ Die Verse	Verse	
Die Überzeugung ~ Die Überzeugungen	Conviction	
Der Rover ~ Die Rover	Rover	
Der Zaunkönig ~ Die Zaunkönige	Wren	
Die Expedition ~ Die Expeditionen	Expedition	
Die Belohnung ~ Die Belohnungen	Reward	
Die Säulen ~ Die Säulen	Pillar	
Die Marmelade ~ Die Marmeladen	Jam	
Der Schnaps ~ Die Brände	Brandy	
Die Residenz ~ Die Residenzen	Residence	
Der Baron ~ Die Barone	Baron	
Das Unternehmen ~ Die Unternehmen	Enterprise	
Der Komplex ~ Die Complexs	Complex	
Der Kandidat ~ Die Kandidaten	Candidate	
Der Triumph ~ Die Triumphes	Triumph	
Die Wendung ~ Die Drehungen	Twist	
Die Skizze ~ Die Skizzen	Sketch	
Das Register ~ Die Register	Register	
Der Herzschlag ~ Die Herzschläge	Heartbeat	
Die Cafeteria ~ Die Cafeterien	Cafeteria	
Die Gebühr ~ Die Gebühren	Fee	
Die Hang ~ Die Hänge	Hillside	
Das Labyrinth ~ Die Labyrinthe	Maze	
Der Fischer ~ Das Fishermans	Fisherman	
Das Brummen ~ Die Summt	Hum	
Das Kätzchen ~ Die Kätzchen	Kitten	
The Dread ~ Die Dreads	Dread	
Die Substanz ~ Die Substanzen	Substance	
Der Knall ~ Der Pony	Bang	
Der Dolch ~ Die Dolche	Dagger	
Das Con ~ Die Nachteile	Con	
Die Einsamkeit ~ Die Einsamkeiten	Loneliness	
Das Motorrad ~ Die Motorräder	Motorcycle	
Das Staunen ~ Die Amazements	Amazement	
Die Peer ~ Die Peers	Peer	
Die Tech ~ Die Teches	Tech	
Die Beleidigung ~ Die Beleidigungen	Insult	
Die Kapazität ~ Die Kapazität	Capacity	
Die Ehrfurcht ~ Die Awes	Awe	
Die Chili ~ Die Chilis	Chili	
Die Lodge ~ Die Logen	Lodge	
Der Clip ~ Die Clips	Clip	
Die Limousine ~ Die Limousinen	Limo	
Die Mücke ~ Die Mücken	Mosquito	
Der Shake ~ Die Shakes	Shake	
Das Festmahl ~ Die Feste	Feast	
Das Casino ~ Die Casinos	Casino	
Die Erbse ~ Die Erbsen	Pea	
Das Murmeln ~ Das Murmeln	Murmur	
Der Konflikt ~ Die Konflikte	Conflict	
Der Stamm ~ Die Stiele	Stem	
Der Genosse ~ Die Genossen	Comrade	
Sob ~ Das Schluchzen	Sob	
Die Schwangerschaft ~ Schwangerschaften	Pregnancy	
Der Verdächtige ~ Die Verdächtigen	Suspect	
Das Zusammentreffen ~ Die Zufälle	Coincidence	
Der Waldläufer ~ Die Ranger	Ranger	
Die Karikatur ~ Die Karikaturen	Cartoon	
Der Mitbewohner ~ Die Mitbewohner	Roommate	
Die Freundlichkeit ~ Die Freundlichkeiten	Kindness	
Der Kreuzer ~ Die Kreuzer	Cruiser	
Die Bramme ~ Die Brammen	Slab	
Das Gewissen ~ Das Gewissen	Conscience	
Die Cheer ~ Der Jubel	Cheer	
Der Konus ~ Die Kegel	Cone	
Die Schaltung ~ Die Schaltkreise	Circuit	
Das Elfenbein ~ Die Elfenbeinarbeiten	Ivory	
Der Zimmermann ~ Die Zimmerleute	Carpenter	
Der Penner ~ Die Bums	Bum	
Die Donna ~ The Donnas	Donna	
Die Reservierung ~ Reservierungen	Reservation	
Die Unterhaltung ~ Die Unterhaltungen	Entertainment	
Die Krabbe ~ Die Krabben	Crab	
Das Stöhnen ~ Das Stöhnen	Groan	
Die Akademie ~ Die Akademien	Academy	
Die Sehnsucht ~ Die Sehnsüchte	Longing	
Die Kip ~ Die Kips	Kip	
Der Bohrer ~ Die Bohrer	Drill	
Das Gepäck ~ Die Den Gepäck	Luggage	
Der Baldachin ~ Die Baldachine	Canopy	
Der Nervenkitzel ~ Den Nervenkitzel	Thrill	
Die Tugend ~ Die Tugenden	Virtue	
Der Schornstein ~ Die Schornsteine	Chimney	
Die Anker ~ Die Anker	Anchor	
Die Harmonie ~ Die Harmonien	Harmony	
Das Ahorn ~ Die Ahorne	Maple	
Das Kaninchen ~ Die Hasen	Bunny	
Der Modus ~ Die Modi	Mode	
Der Thron ~ Die Throne	Throne	
Der Antrag ~ Anwendungen	Application	
Die Physik ~ Die Physicsies	Physics	
Das Neon ~ Die Neons	Neon	
Die Luftschleuse ~ Die Luftschleusen	Airlock	
Die Ermüdungs ~ Die Strapazen	Fatigue	
Die Danksagung ~ Die Danksagungen	Thanksgiving	
Das Manuskript ~ Die Handschriften	Manuscript	
Die Basis ~ Die Basises	Basis	
Das Denkmal ~ Gedenkstätten	Memorial	
Die Japaner ~ Die Japaneses	Japanese	
Das Engineering ~ Die Engineerings	Engineering	
Die Linke ~ Die Linke	Left	
Die Bronze ~ Die Bronzen	Bronze	
Die Assoziation ~ Die Verbände	Association	
Der Marker ~ Die Marker	Marker	
Die Beute ~ Die Beute	Prey	
Die Episode ~ Die Episoden	Episode	
Der Ursprung ~ Die Ursprünge	Origin	
Das Vakuum ~ Die Staubsauger	Vacuum	
Die Kathedrale ~ Die Kathedralen	Cathedral	
Das Management ~ Die Unternehmensleitungen	Management	
Die Nach Unten ~ Die Tiefen	Down	
Der Kontinent ~ Die Kontinente	Continent	
Zum Teufel ~ Die Dickenses	Dickens	
Die Freiwillige ~ Die Freiwilligen	Volunteer	
Fußball ~ Die Soccers	Soccer	
Der Saum ~ Die Säume	Hem	
Die Erwähnung ~ Nennungen	Mention	
Die Lust ~ Die Begierden	Lust	
Die Kichern ~ Das Kichern	Giggle	
Die Klassenkameraden ~ Die Klassenkameraden	Classmate	
Die Reinigung ~ Die Reinigungen	Cleaning	
Der Rezeptionist ~ An Der Rezeption	Receptionist	
Der Anrufer ~ Die Anrufer	Caller	
Das Streben ~ Die Beschäftigungen	Pursuit	
Die Verachtung ~ Die Geringschätzungen	Contempt	
Die Großeltern ~ Die Großeltern	Grandparent	
Der Grenzbereich ~ Die Schwellen	Threshold	
Die Tat ~ Die Taten	Deed	
Das Artefakt ~ Die Artefakte	Artifact	
Die Falten ~ Die Falten	Wrinkle	
Der Magier ~ Die Zauberer	Magician	
Der Stich ~ Die Stiche	Pang	
Die Italienische ~ Die Italiener	Italian	
Die Ewigkeit ~ Die Ewigkeit	Eternity	
Der Schiefer ~ Die Schiefertafeln	Slate	
Die Ankündigung ~ Die Ankündigungen	Announcement	
Das Motiv ~ Die Motive	Motive	
Der Mechaniker ~ Die Mechanik	Mechanic	
Der Verbündete ~ Alliierten	Ally	
Die Vase ~ Die Vasen	Vase	
Der Verkäufer ~ Die Salesmans	Salesman	
Der Therapeut ~ Die Therapeuten	Therapist	
Die Oma ~ Die Omas	Granny	
Der Außenseiter ~ Die Mavericks	Maverick	
Die Bandage ~ Die Bandagen	Bandage	
Der Schinken ~ Die Schinken	Ham	
Der Fuhrmann ~ Die Fuhr	Carter	
Die Investition ~ Die Investitionen	Investment	
Die Beschwerde ~ Die Rechtsmittel	Appeal	
Die Unschuld ~ Die Innocences	Innocence	
Der Kalender ~ Die Kalender	Calendar	
Die Dach ~ Die Dächer	Rooftop	
Die Offenbarung ~ Die Enthüllungen	Revelation	
Der Pfannkuchen ~ Die Pfannkuchen	Pancake	
Der Asteroid ~ Die Asteroiden	Asteroid	
Die Postkarte ~ Die Postkarten	Postcard	
Das Kleidungsstück ~ Die Kleidungsstücke	Garment	
Die Bestimmung ~ Die Bestimmungen	Determination	
Der Traktor ~ Die Traktoren	Tractor	
Die Beere ~ Die Beeren	Berry	
Die Umgebung ~ Die Surroundingses	Surroundings	
Die Straftat ~ Die Straftaten	Offense	
Die Einleitung ~ Die Einleitungen	Introduction	
Der Butler ~ The Butlers	Butler	
Der Husten ~ Die Coughes	Cough	
Der Granit ~ Die Granite	Granite	
Der Botschafter ~ Die Botschafter	Ambassador	
Der Wende ~ Die Späne	Turning	
Das Kompliment ~ Die Komplimente	Compliment	
Der Karton ~ Die Schachteln	Carton	
Die Türklingel ~ Die Türklingeln	Doorbell	
Die Gewissheit ~ Die Gewissheiten	Certainty	
Der Politiker ~ Die Politiker	Politician	
Die Dankbarkeit ~ Die Danksagungen	Gratitude	
Die Jetzige ~ Die Ströme	Current	
Das Dunkel ~ Die Düsterkeit	Gloom	
Der Putz ~ Die Pflaster	Plaster	
Die Siedlung ~ Die Siedlungen	Settlement	
Die Chop ~ Die Koteletts	Chop	
Die Mordkommission ~ Die Tötungsdelikte	Homicide	
Die Aluminium ~ Die Aluminums	Aluminum	
Der Boulevard ~ Die Boulevards	Boulevard	
Der Schüler ~ Die Schülerinnen Und Schüler	Pupil	
Der Schwimmer ~ Die Schwimmer	Float	
Der Beruf ~ Berufe	Profession	
Der Rückzug ~ Die Exerzitien	Retreat	
Der Schnittpunkt ~ Die Schnittpunkte	Intersection	
Die Regelung ~ Die Systeme	Scheme	
Die Leere ~ Die Emptinesses	Emptiness	
Der Verlag ~ Die Verleger	Publisher	
Der Zirkus ~ Die Zirkusse	Circus	
Die Abmessung ~ Die Dimensionen	Dimension	
Der Tierpark ~ Die Zoos	Zoo	
Der Bote ~ Die Boten	Messenger	
Das Beau ~ Die Beaus	Beau	
Das Gewirr ~ Die Tangles	Tangle	
Das Personal ~ Die Personnels	Personnel	
Die Strategie ~ Die Strategien	Strategy	
Der Geschäftsmann ~ Die Business	Businessman	
The Pod ~ Die Schoten	Pod	
Der Abfluss ~ Die Drain	Drain	
Die Erdbeere ~ Die Erdbeeren	Strawberry	
Der Jahrestag ~ Die Jahrestage	Anniversary	
Das Fernglas ~ Die Binocularses	Binoculars	
Die Kluft ~ Die Buchten	Gulf	
Die Disziplin ~ Die Disziplinen	Discipline	
Die Hecke ~ Die Hecken	Hedge	
Das Einkommen ~ Die Einkommen	Income	
Der Mythos ~ Die Mythen	Myth	
Der Verschluss ~ Die Fensterläden	Shutter	
Das Floß ~ Die Flöße	Raft	
Der Arzt ~ Die Ärzte	Physician	
Der Ehrgeiz ~ Die Ambitionen	Ambition	
Das Kamel ~ Die Kamele	Camel	
Das Schlagen ~ Die Schläge	Beating	
Die Säure ~ Die Säuren	Acid	
Müsli ~ Getreide	Cereal	
Das Becken ~ Die Becken	Basin	
Das Nachthemd ~ Die Nachthemden	Nightgown	
Das Internet ~ Die Internets	Internet	
Das Cockpit ~ Die Cockpits	Cockpit	
Das Wrack ~ Die Wracks	Wreck	
Die Perücke ~ Die Perücken	Wig	
Darin ~ Die Zügel	Rein	
Der Recorder ~ Die Rekorder	Recorder	
Das Schweinefleisch ~ Die Porks	Pork	
Die Prüfung ~ Die Prüfungen	Exam	
Die Höflichkeit ~ Die Höflichkeiten	Courtesy	
Die Hilfe ~ Die Unterstützungen	Assistance	
Die Wangenknochen ~ Die Wangenknochen	Cheekbone	
Die Peitsche ~ Die Peitschen	Whip	
Der Pilger ~ Die Pilger	Pilgrim	
Der Kollaps ~ Die Zusammenbrüche	Collapse	
Die Fakultät ~ Die Fakultäten	Faculty	
Die Erinnerung ~ Die Erinnerungen	Reminder	
Der Weise ~ Die Weisen	Sage	
Der Asphalt ~ Die Asphalte	Asphalt	
Das Privileg ~ Die Privilegien	Privilege	
Das Treppenhaus ~ Die Treppen	Stairway	
Die Wartung ~ Die Wartungen	Maintenance	
Die Süße ~ Die Süßigkeiten	Sweetie	
Der Obstgarten ~ Die Obstgärten	Orchard	
Das Kinderbett ~ Die Kinderbetten	Cot	
Das Feuerzeug ~ Die Feuerzeuge	Lighter	
Die Katze ~ Die Kätzchen	Kitty	
Die Formation ~ Die Formationen	Formation	
Die Snack ~ Die Snacks	Snack	
Das Reden ~ Die Gesprächen	Talking	
Die Op ~ Die Ops	Op	
Die Skulptur ~ Die Skulpturen	Sculpture	
Der Vorsitzende ~ Die Chair	Chairman	
Die Summe ~ Die Summen	Sum	
Die Karotte ~ Die Karotten	Carrot	
Die Welligkeit ~ Die Wellen	Ripple	
Die Radar ~ Die Radare	Radar	
Der Pferdeschwanz ~ Die Pferdeschwänze	Ponytail	
Der Designer ~ Die Designer	Designer	
Die Stoß ~ Die Überspannungen	Surge	
Der Erbe ~ Die Erben	Heir	
Der Bunker ~ Die Gewölbe	Vault	
Die Sissy ~ Die Weicheier	Sissy	
Die Schotten ~ Die Bremsschuhe	Scotch	
Die Stille ~ Die Stillnesses	Stillness	
Die Tunika ~ Die Tuniken	Tunic	
Der Think ~ Das Denkt	Think	
Der Penis ~ Die Penisse	Penis	
Der Einheimische ~ Die Eingeborenen	Native	
Das Liebesspiel ~ Die Lovemakings	Lovemaking	
Der Adjutant ~ Die Helfer	Aide	
Der Großteil ~ Die Massen	Bulk	
Die Poker ~ Die Poker	Poker	
Der Kalk ~ Der Limes	Lime	
Das Überwachungs ~ Die Anwendungsbeobachtungen	Surveillance	
Die Versammlung ~ Die Baugruppen	Assembly	
Der Enkel ~ Die Enkel	Grandson	
Der Chopper ~ Die Zerhacker	Chopper	
Der Träger ~ Die Träger	Carrier	
Die Verlobung ~ Die Engagements	Engagement	
Das Kin ~ Die Kins	Kin	
Die Beleuchtung ~ Die Beleuchtung	Lighting	
Die Passform ~ Die Anfälle	Fit	
Die Pull ~ Die Zieht	Pull	
The Verge ~ Die Seitenstreifen	Verge	
Das Bauernhaus ~ Die Bauernhäuser	Farmhouse	
Das Warten ~ Die Wartezeiten	Wait	
Der Attentäter ~ Die Attentäter	Assassin	
Der Schaum ~ Die Schäume	Foam	
Der Schlepper ~ Die Schlepper	Tug	
Der Journalist ~ Die Journalisten	Journalist	
Die Aufnahme ~ Die Aufnahmen	Recording	
Die Heilung ~ Die Heilungen	Cure	
Der Abstieg ~ Die Abfahrten	Descent	
Das Klingeln ~ Die Ringings	Ringing	
Die Schere ~ Die Scissorses	Scissors	
Der Zweig ~ Die Zweige	Twig	
Der Urlaubsort ~ Die Ferienorte	Resort	
Der Beschützer ~ Die Wächter	Guardian	
Der Gegner ~ Die Gegner	Opponent	
Der Küchenchef ~ Die Köche	Chef	
Der Weizen ~ Die Weizen	Wheat	
Der Hurrikan ~ Die Hurrikane	Hurricane	
Der Spielplatz ~ Die Spielplätze	Playground	
Der Pilz ~ Die Pilze	Mushroom	
Die Tastatur ~ Die Keyboaries	Keyboard	
Die Zeder ~ Die Zedern	Cedar	
Das Wappen ~ Die Kämme	Crest	
Der Jasmin ~ Die Jasmin	Jasmine	
Der Sessel ~ Die Sessel	Armchair	
Die Attraktion ~ Attraktionen	Attraction	
Blinde ~ Die Blinds	Blind	
Zylinder ~ Die Zylinder	Cylinder	
Die Schwalbe ~ Die Schwalben	Swallow	
Die Berühmtheit ~ Die Prominenten	Celebrity	
Die Wildnis ~ Die Wildnis	Wilderness	
Das Dreieck ~ Die Dreiecke	Triangle	
Der Gestank ~ Die Gestank	Stench	
Das Labor ~ Die Laboratorien	Laboratory	
Das Array ~ Die Arraies	Array	
The Valentine ~ Die Valentines	Valentine	
Das Renten ~ Die Pensionierungen	Retirement	
Der Ski ~ Die Skier	Ski	
Die Ausgabe ~ Die Ausgaben	Edition	
Der Supervisor ~ Die Aufsichtsbehörden	Supervisor	
Die Weite ~ Die Weiten	Expanse	
Das Ende ~ Die Endungen	Ending	
Das Moos ~ Die Moose	Moss	
Der Sturm ~ Die Stürme	Gale	
Die Treue ~ Die Loyalitäten	Loyalty	
Der Lavendel ~ Die Lavendel	Lavender	
Die Begnadigung ~ Die Begnadigungen	Pardon	
Der Aschenbecher ~ Die Aschenbecher	Ashtray	
Die Scherbe ~ Die Scherben	Shard	
Das Unternehmen ~ Die Konzerne	Corporation	
Die Ablenkung ~ Die Ablenkungen	Distraction	
Die Majestät ~ Die Majestäten	Majesty	
Die Pyramide ~ Die Pyramiden	Pyramid	
Der Ruhm ~ Die Fames	Fame	
Der Schulabschluss ~ Die Unterteilungen	Graduation	
Die Not ~ Die Nöte	Distress	
Der Magier ~ Die Magier	Mage	
Die Unabhängigkeit ~ Die Unabhängigkeiten	Independence	
Der Schwarm ~ Die Zermalmt	Crush	
Das Lachen ~ Die Kichert	Chuckle	
Die Dime ~ Die Dimes	Dime	
Die Böen ~ Die Böen	Gust	
Der Russe ~ Die Russen	Russian	
Der Festlichkeit ~ Die Leckereien	Treat	
Der Ausländer ~ Die Ausländer	Foreigner	
Das Gehalt ~ Die Gehälter	Salary	
Der Anwendungsbereich ~ Die Bereiche	Scope	
Der Rebell ~ Die Rebellen	Rebel	
Der Schläger ~ Die Schläger	Thug	
Die Steckdose ~ Die Buchsen	Socket	
Die Dosis ~ Die Dosen	Dose	
Die Wahl ~ Die Wahlen	Election	
Der Flüchtling ~ Die Flüchtlinge	Refugee	
Die Phase ~ Die Phasen	Phase	
Der Kürbis ~ Die Kürbisse	Pumpkin	
Der Dorn ~ Die Dornen	Thorn	
Die Wurst ~ Die Würste	Sausage	
Die Dig ~ Die Ausgrabungen	Dig	
Der Tan ~ Die Bräunt	Tan	
Das Darlehen ~ Die Kredite	Loan	
Der Dorn ~ Die Spikes	Spike	
Die Krume ~ Die Krümel	Crumb	
Das Wachs ~ Waxs	Wax	
Das Knurren ~ Die Growls	Growl	
Die Vermietung ~ Vermietungen	Rental	
Das Futter ~ Die Zuführungen	Feed	
Die Eskorte ~ Die Begleitpersonen	Escort	
Das Erstaunen ~ Die Erstaunlichkeiten	Astonishment	
Die Flora ~ Die Floren	Flora	
Das Fest ~ Die Feste	Festival	
Die Debatte ~ Die Debatten	Debate	
Der Kritiker ~ Die Kritiker	Critic	
Die Besetzung ~ Die Modelle	Cast	
Das Loft ~ Die Dachböden	Loft	
Die Kommission ~ Die Kommissionen	Commission	
Das Flimmern ~ Die Flackert	Flicker	
Die Wirtschaft ~ Die Volkswirtschaften	Economy	
Die Strahlung ~ Die Strahlungen	Radiation	
Der Leibwächter ~ Die Bodyguaries	Bodyguard	
Die Umsetzung ~ Die Erkenntnisse	Realization	
Der Krater ~ Die Krater	Crater	
Das Kongress ~ Die Kongresse	Congress	
Die Wahl ~ Die Stimmen	Vote	
Der Antrag ~ Vorschläge	Proposal	
Der Braten ~ Die Pommes	Fry	
Das Zittern ~ Gänsehaut	Shiver	
Die Verpflichtung ~ Verpflichtungen	Obligation	
Der Verlierer ~ Die Verlierer	Loser	
Der Lehrer ~ Die Ausbilder	Instructor	
Die Zuzwinkern ~ Die Zwinkert	Wink	
Die Kies ~ Die Kieselsteine	Pebble	
Die Notwendigkeit ~ Die Notwendigkeiten	Necessity	
Der Workshop ~ Die Workshops	Workshop	
Der Sonnenaufgang ~ Die Sonnenaufgang	Sunrise	
Die Erschöpfung ~ Die Erschöpfungs	Exhaustion	
Die Zelle ~ Die Schränke	Cubicle	
Der Doppelgänger ~ Die Doppelgänger	Double	
Der Umfang ~ Die Umfänge	Perimeter	
Der Kamm ~ Die Kämme	Comb	
Das Ende ~ Die Oberflächen	Finish	
Der Kauf ~ Die Käufe	Purchase	
Das Intervall ~ Die Intervalle	Interval	
Der Spritz ~ Die Spritzer	Splash	
Die Konvention ~ Die Konventionen	Convention	
Das Bewusstsein ~ Die Gewahrsein	Awareness	
Die Pose ~ Die Posen	Pose	
Die Wiege ~ Die Wiegen	Cradle	
Der Stößel ~ Die Widder	Ram	
Der Adel ~ Die Gentries	Gentry	
Die Naht ~ Die Nähte	Seam	
Das Assoziierte Unternehmen ~ Die Mitarbeiter	Associate	
Der Punk ~ Die Punks	Punk	
Der Überrest ~ Die Reste	Remnant	
Der Cracker ~ Die Cracker	Cracker	
Der Bluff ~ Die Klippen	Bluff	
Die Düne ~ Die Dünen	Dune	
Der Zahnarzt ~ Die Zahnärzte	Dentist	
Die Zuflucht ~ Die Schutzhütten	Refuge	
Die Satin ~ Die Satins	Satin	
Die Verbreitung ~ Die Spreads	Spread	
Das Unternehmen ~ Die Entitäten	Entity	
Das Postfach ~ Die Mailboxs	Mailbox	
Der Ärger ~ Die Ärgernisse	Annoyance	
Das Zischen ~ Die Zischt	Hiss	
Das Lokal ~ Die Einheimischen	Local	
Der Bums ~ Die Schläge	Thud	
Die Bestürzung ~ Die Bestürzt	Dismay	
Das Mehl ~ Die Mehle	Flour	
Der Freak ~ Die Freaks	Freak	
Der Haarschnitt ~ Die Abschläge	Haircut	
Die Waise ~ Die Waisen	Orphan	
Das Schach ~ Die Chesses	Chess	
Die Blütenblatt ~ Die Blütenblätter	Petal	
Die Schreibarbeit ~ Die Papierarbeiten	Paperwork	
Der Psychiater ~ Die Psychiater	Psychiatrist	
Der Gesang ~ Die Gesänge	Singing	
Das Interrupt ~ Die Interrupts	Interrupt	
Die Untersuchung ~ Untersuchungen	Examination	
Die Bewunderung ~ Die Bewunderung	Admiration	
Das Gefrier ~ Die Gefriergeräte	Freezer	
Die Illustration ~ Abbildungen	Illustration	
Der Eintopf ~ Die Eintöpfe	Stew	
Der Ermittler ~ Die Ermittler	Investigator	
Der Vorort ~ Der Stadtrand	Suburb	
Das Holster ~ Die Holster	Holster	
Der Faktor ~ Die Faktoren	Factor	
Die Intimität ~ Die Intimitäten	Intimacy	
Die Peitsche ~ Die Wimpern	Lash	
Die Einsparung ~ Die Einsparungen	Saving	
Die Software ~ Die Software	Software	
Die Henne ~ Die Hennen	Hen	
Die Birke ~ Die Birken	Birch	
Die Untersuchung ~ Die Anfragen	Inquiry	
Der Kindergarten ~ Die Baumschulen	Nursery	
Der Transport ~ Die Transporte	Transport	
Das Ausmaß ~ Die Ausdehnungen	Extent	
Die Definition ~ Die Definitionen	Definition	
Das Monument ~ Die Denkmäler	Monument	
Die Pflaume ~ Die Pflaumen	Plum	
Das Nichts ~ Die Hohlräume	Void	
Die Verzögerung ~ Die Verzögerungen	Delay	
Die Inspektion ~ Die Inspektionen	Inspection	
Die Essenz ~ Die Essenzen	Essence	
Die Kanone ~ Die Kanonen	Cannon	
Die Fransen ~ Die Fransen	Fringe	
Die Stereo ~ Die Stereoanlagen	Stereo	
Die Fella ~ Fellas	Fella	
Das Lob ~ Das Lob	Praise	
Der Pinguin ~ Die Pinguine	Penguin	
Die Folter ~ Die Qualen	Torture	
Die Briefmarke ~ Die Briefmarken	Stamp	
Die Partikel ~ Die Teilchen	Particle	
Der Übersetzer ~ Die Übersetzer	Translator	
Ostern ~ Die Easters	Easter	
Das Einfrieren ~ Die Friert	Freeze	
Die Pew ~ Die Bänke	Pew	
Der Pfropfen ~ Die Bündel	Wad	
Das Höschen ~ Die Pantieses	Panties	
Die Gegenleistung ~ Überlegungen	Consideration	
Der Spieß ~ Die Spieße	Spit	
Der Kühler ~ Die Kühler	Cooler	
Der Grill ~ Die Grills	Grill	
Der Spitzname ~ Die Spitznamen	Nickname	
Der Revolver ~ Die Revolver	Revolver	
Die Maschinen ~ Die Maschinen	Machinery	
Die Damen Und Herren ~ Die Herren	Madam	
Der Hecht ~ Pikes	Pike	
Der Terrorist ~ Die Terroristen	Terrorist	
Der Laptop ~ Die Laptops	Laptop	
Das Angebot ~ Das Angebot	Offering	
Der Schnabel ~ Die Schnäbel	Beak	
Die Institution ~ Die Institutionen	Institution	
Der Vergleich ~ Vergleiche	Comparison	
Der Macher ~ Die Macher	Maker	
Die Einsicht ~ Die Erkenntnisse	Insight	
Die Geschwister ~ Die Geschwister	Sibling	
Der Kleiderschrank ~ Die Schränke	Wardrobe	
Die Klappe ~ Die Klappen	Flap	
Der Einzige ~ Die Sohlen	Sole	
Das Mitgefühl ~ Die Barmherzigkeit	Compassion	
Das Ego ~ Die Egos	Ego	
Die Antennen ~ Die Antennen	Antenna	
Die Grille ~ Die Grillen	Cricket	
Der Troll ~ Die Trolle	Troll	
Der Bücherladen ~ Die Buchhandlungen	Bookstore	
Die Ankunft ~ Das Kommen	Coming	
Der Einwand ~ Die Einwände	Objection	
Der Halter ~ Die Inhaber	Holder	
Rücksitz ~ Die Rücksitze	Backseat	
Die Unwissenheit ~ Die Unwissenheit	Ignorance	
Das Budget ~ Die Budgets	Budget	
Das Korps ~ Die Leichen	Corps	
Das Brot ~ Die Laibe	Loaf	
Die Erweiterung ~ Die Verlängerungen	Extension	
Die Einsamkeit ~ Die Einsamkeit	Solitude	
Die Chemische ~ Chemikalien	Chemical	
Der Dorfbewohner ~ Die Dorfbewohner	Villager	
Die Perfektion ~ Die Vollkommen	Perfection	
Der Papst ~ Die Päpste	Pope	
Das Semester ~ Die Semester	Semester	
Die Leber ~ Die Lebern	Liver	
Die Untertasse ~ Die Untertassen	Saucer	
Die Dringlichkeit ~ Die Dringlichkeiten	Urgency	
Der Vulkan ~ Die Vulkane	Volcano	
Die Würze ~ Die Gewürze	Spice	
Die Geisel ~ Die Geiseln	Hostage	
Der Teig ~ Die Teigrunder	Dough	
Die Aufregung ~ Die Unruhen	Commotion	
Gerichtsgebäude ~ Die Gerichtsgebäuden	Courthouse	
Der Lachs ~ Die Lachse	Salmon	
Der Boxer ~ Die Boxer	Boxer	
Die Besorgung ~ Die Besorgungen	Errand	
Wobei Der Mechanismus ~ Die Mechanismen	Mechanism	
Das Teleskop ~ Die Teleskope	Telescope	
Die Fähre ~ Die Fähren	Ferry	
Der Nigger ~ Die Nigger	Nigger	
Der Passant ~ Die Passanten	PasserBy	
Die Reizung ~ Die Irritationen	Irritation	
Das Engagement ~ Verpflichtungen	Commitment	
Der Feigling ~ Die Feiglinge	Coward	
Die Git ~ Die Gits	Git	
Das Heulen ~ Das Heulen	Howl	
Die Fang ~ Die Reißzähne	Fang	
Die Römisch ~ Die Römer	Roman	
Der Farbton ~ Die Farbtöne	Hue	
Das Unbehagen ~ Die Unannehmlichkeiten	Discomfort	
Das Entlüftungs ~ Die Lüftungsschlitze	Vent	
Das Kanu ~ Die Kanus	Canoe	
Das Rezept ~ Die Rezepte	Recipe	
Der Hamburger ~ Die Hamburger	Hamburger	
Die Traufe ~ Die Traufe	Eave	
Der Barbier ~ Die Barbiere	Barber	
Das Ableben ~ Die Passings	Passing	
Der Verrat ~ Der Verrat	Betrayal	
Das Sweatshirt ~ Die Sweatshirts	Sweatshirt	
Die Tentakel ~ Die Tentakeln	Tentacle	
Die Brandung ~ Die Brandungen	Surf	
Das Plaid ~ Die Plaids	Plaid	
Der Gehweg ~ Die Gehwege	Walkway	
Das Hinken ~ Die Hinkt	Limp	
Die Verwaltung ~ Die Verwaltungen	Administration	
Die Bequemlichkeit ~ Bequemlichkeiten	Convenience	
Die Windel ~ Die Windeln	Diaper	
Der Maulwurf ~ Die Maulwürfe	Mole	
Der Reiniger ~ Die Reinigungskräfte	Cleaner	
Die Dünung ~ Die Schwillt	Swell	
Der Erwachsene ~ Die Erwachsenen	GrownUp	
Die Scan ~ Die Abtastungen	Scan	
Die Klarheit ~ Die Klarheiten	Clarity	
Der Salon ~ Die Salons	Salon	
Der Produzent ~ Die Hersteller	Producer	
Die Flug ~ Die Flusen	Flying	
Der Rechtsmittelgrund ~ Die Rechtsmittelgründe	Plea	
Die Prärie ~ Die Prärien	Prairie	
Die Alternative ~ Alternativen	Alternative	
Die Eitelkeit ~ Die Eitelkeiten	Vanity	
Der Damm ~ Die Dämme	Dam	
Der Missbrauch ~ Die Missbräuche	Abuse	
Die Olive ~ Die Oliven	Olive	
Der Bergmann ~ Die Bergleute	Miner	
Die Reserve ~ Die Reserven	Reserve	
Die Sicherungs ~ Die Sicherungen	Backup	
Die Gegensprechanlage ~ Die Gegensprechanlagen	Intercom	
Das Tuch ~ Die Schals	Shawl	
Der Plattenteller ~ Die Platten	Platter	
Die Implikation ~ Die Auswirkungen	Implication	
Das Poltern ~ Die Rumpelt	Rumble	
Der Ansager ~ Die Ansager	Announcer	
Die Trümmer ~ Die Trümmern	Rubble	
Die Axt ~ Die Achsen	Axe	
Die Übertragungs ~ Die Übertragungen	Transmission	
Die Krippe ~ Die Krippen	Crib	
Die Sprung ~ Der Hopfen	Hop	
Das Aroma ~ Die Aromen	Aroma	
Der Dialog ~ Die Dialoge	Dialogue	
Die Walze ~ Die Rollen	Roller	
Gemeinde ~ Die Gemeinden	Congregation	
Das Gelände ~ Die Terrains	Terrain	
Der Transfer ~ Die Transfers	Transfer	
Die Hardware ~ Die Hardwares	Hardware	
Der Generator ~ Die Generatoren	Generator	
Die Luxus ~ Der Luxus	Luxury	
Das Auditorium ~ Die Auditorien	Auditorium	
Der Kobold ~ Die Goblins	Goblin	
Der Zapfen ~ Die Zapfen	Peg	
Die Niederlage ~ Die Niederlagen	Defeat	
The Haven ~ Die Oasen	Haven	
Die Probe ~ Die Proben	Specimen	
Der Herd ~ Die Feuerstellen	Hearth	
Die Zulassung ~ Die Zulassungs	Admission	
Die Besessenheit ~ Die Obsessionen	Obsession	
Der Start ~ Die Starts	Launch	
Die Patsy ~ Die Sündenböcke	Patsy	
Das Wohnheim ~ Die Schlafsäle	Dorm	
The Glen ~ Die Täler	Glen	
Die Säge ~ Die Sägen	Saw	
Die Til ~ Die Tils	Til	
Der Staffelungs ~ Die Wankt	Stagger	
Die Fotze ~ Die Fotzen	Pussy	
Der Sammler ~ Die Kollektoren	Collector	
Das Erdbeben ~ Die Erdbeben	Earthquake	
Die Flocke ~ Die Flocken	Flake	
Die Silbe ~ Die Silben	Syllable	
Das Bouquet ~ Die Blumensträuße	Bouquet	
Die Auswahl ~ Die Selektionen	Selection	
Der Schwur ~ Die Gelübde	Vow	
Die Enkelin ~ Die Enkel	Granddaughter	
Das Symptom ~ Die Symptome	Symptom	
Das Szenario ~ Die Szenarien	Scenario	
Der Aufruhr ~ Die Unruhen	Riot	
Das Timing ~ Die Zeitpunkte	Timing	
Der Burger ~ Die Burger	Burger	
Die Plus ~ Die Pluspunkte	Plus	
Der Spatz ~ Die Spatzen	Sparrow	
Die Botschaft ~ Die Botschaften	Embassy	
Das Podium ~ Die Podestplätze	Podium	
Der Vorwurf ~ Die Vorwürfe	Accusation	
Das Herrenhaus ~ Die Herrenhäuser	Manor	
Das Schlurfen ~ Die Shufflings	Shuffling	
Der Delfin ~ Die Delphine	Dolphin	
Der Wasserkocher ~ Die Kessel	Kettle	
Die Rettung ~ Die Rettungen	Salvation	
Der Tierarzt ~ Die Tierärzte	Vet	
Die Landebahn ~ Die Start Und Landebahnen	Runway	
Der Mohn ~ Der Mohn	Poppy	
Im Obergeschoss ~ Die Upstairses	Upstairs	
Die Lava ~ Die Laven	Lava	
Die Inspiration ~ Die Inspirationen	Inspiration	
Der Busen ~ Die Busen	Bosom	
Der Eindringling ~ Die Eindringlinge	Intruder	
Der Supermarkt ~ Die Supermärkte	Supermarket	
Der Pokal ~ Die Trophäen	Trophy	
Die Eifersucht ~ Die Eifersucht	Jealousy	
Der Aufseher ~ Des Direktors	Warden	
Der Yachthafen ~ Die Jachthäfen	Marina	
Das Lebewohl ~ Die Abschiede	Farewell	
Die Gegenstände ~ Der Zugehörigkeit	Belongings	
Die Prozession ~ Die Prozessionen	Procession	
Der Astronaut ~ Die Astronauten	Astronaut	
Der Schritt ~ Die Gabelungen	Crotch	
Die Sweep ~ Die Sweeps	Sweep	
Die Erholung ~ Die Wiederfindungen	Recovery	
Der Kabelbaum ~ Die Kabelbäume	Harness	
Das Logo ~ Die Logos	Logo	
Der Wurf ~ Die Würfe	Litter	
Die Marine ~ Die Marines	Marine	
Der Groll ~ Die Ressentiments	Resentment	
Der CoOp ~ Die Genossenschaften	CoOp	
The Drake ~ Die Drachen	Drake	
Der Zigeuner ~ Die Zigeuner	Gypsy	
Die Nachahmung ~ Die Imitationen	Imitation	
Der Arbeitgeber ~ Arbeitgeber	Employer	
Der Neuling ~ Die Freshmans	Freshman	
Das Phänomen ~ Die Phänomene	Phenomenon	
Die Flöte ~ Die Flöten	Flute	
Der Grieche ~ Die Griechen	Greek	
Die Wohnung ~ Die Eigentumswohnungen	Condo	
Der Zeigefinger ~ Die Zeigefingern	Forefinger	
Das Begräbnis ~ Die Bestattungen	Burial	
Die Republik ~ Die Republiken	Republic	
Der Smaragd ~ Die Smaragde	Emerald	
Der Bademantel ~ Die Bademäntel	Bathrobe	
Das Zeugnis ~ Die Zeugenaussagen	Testimony	
Das Scharnier ~ Die Scharniere	Hinge	
Die Bäckerei ~ Die Bäckereien	Bakery	
Der Kontext ~ Die Kontexte	Context	
Das Schnäppchen ~ Die Schnäppchen	Bargain	
Das Sprichwort ~ Die Sprüche	Saying	
Der Vorarbeiter ~ Die Foremans	Foreman	
Der Schwan ~ Die Schwäne	Swan	
Die Flanell ~ Die Waschlappen	Flannel	
Die Angabe ~ Die Indikationen	Indication	
Die Signifikanz ~ Die Bedeutungen	Significance	
Der Käfer ~ Die Käfer	Beetle	
Die Lern ~ Die Erkenntnisse	Learning	
Das Lokal ~ Die Pubs	Pub	
Die Fraktion ~ Die Fraktionen	Fraction	
Die Forelle ~ Die Forellen	Trout	
Die Kruste ~ Die Krusten	Crust	
Die Überzugs ~ Die Mäntel	Overcoat	
Das Glitzern ~ Die Reflexen	Glint	
Die Medaille ~ Die Medaillen	Medal	
Die Wahrnehmung ~ Die Wahrnehmungen	Perception	
Das Willkommen ~ Die Willkommen	Welcome	
Das Wörterbuch ~ Die Wörterbücher	Dictionary	
Die Metapher ~ Die Metaphern	Metaphor	
Die Armut ~ Die Poverties	Poverty	
Die Haupt ~ Netz	Main	
Der Anstieg ~ Die Anstiege	Climb	
Die Leine ~ Die Leinen	Leash	
